阿	aF
挨	aiA
捱	aiAB
癌	aiB
皑	aiBB
皚	aiBM
凒	aiBN
賹	aiBO
皧	aiBP
溾	aiEM
溰	aiEN
濭	aiEO
隘	aiF
阨	aiFM
隑	aiFN
絠	aiFO
焥	aiHM
锿	aiJ
鎄	aiJM
鑀	aiJN
哀	aiK
毐	aiMM
騃	aiMN
瞹	aiMO
嫒	aiN
嬡	aiNM
娭	aiNN
娾	aiNO
鴱	aiNP
唉	aiO
哎	aiOB
呆	aiOC
嗳	aiOD
嗌	aiOE
噯	aiOM
啀	aiON
嘊	aiOO
碍	aiP
砹	aiPB
礙	aiPM
硙	aiPN
硋	aiPO
磑	aiPP
欬	aiQM
欸	aiQN
霭	aiR
暧	aiRB
靄	aiRM
曖	aiRN
昹	aiRO
靉	aiRP
矮	aiS
嵦	aiSM
叆	aiSN
躷	aiSO
餲	aiSP
埃	aiT
堨	aiTM
塧	aiTN
壒	aiTO
艾	aiU
蔼	aiUB
藹	aiUM
薆	aiUN
伌	aiVM
佁	aiVN
僾	aiVO
瑷	aiW
璦	aiWM
敱	aiWN
敳	aiWO
愛	aiXM
懓	aiXN
懝	aiXO
馤	aiXP
誒	aiYM
諰	aiYN
譪	aiYO
譺	aiYP
鱫	aiYQ
爱	aiZ
锕	aJ
錒	aJM
腌	aL
按	anA
揞	anAB
安	anB
痷	anBM
厂	anC
厈	anCM
洝	anEM
隌	anFM
鞍	anG
庵	anGB
广	anGC
骯	angGM
枊	angIM
卬	angJM
肮	angL
盎	angM
鞌	anGML
醠	angQM
昂	angR
昻	angRM
岇	angSM
黯	anH
案	anI
桉	anIB
铵	anJ
銨	anJM
錌	anJN
裺	anKM
胺	anL
腤	anLM
盦	anMM
闇	anMN
盫	anMO
鹌	anN
鵪	anNM
婩	anNN
媕	anNO
鶕	anNP
咹	anOM
唵	anON
啽	anOO
氨	anQ
犴	anQB
暗	anR
晻	anRM
雸	anRN
岸	anS
屵	anSM
屽	anSN
峖	anSO
罯	anSP
埯	anT
垵	anTM
堓	anTN
荌	anUM
菴	anUN
葊	anUO
萻	anUP
蓭	anUQ
俺	anV
侒	anVM
偣	anVN
儑	anVO
玵	anWM
馣	anXM
谙	anY
諳	anYM
誝	anYN
鮟	anYO
韽	anYP
豻	anZM
貋	anZN
啊	aO
拗	aoA
扷	aoAM
抝	aoAN
摮	aoAO
擙	aoAP
呵	aOB
嗄	aOC
螯	aoCL
镺	aoCM
軪	aoCN
厫	aoCO
奥	aoD
吖	aODL
奧	aoDM
奡	aoDN
澳	aoE
泑	aoEM
滶	aoEN
澚	aoEO
聱	aoF
郩	aoFM
隞	aoFN
隩	aoFO
廒	aoG
熬	aoH
熝	aoHM
爊	aoHN
柪	aoIM
梎	aoIN
鏊	aoJ
凹	aoK
袄	aoKB
襖	aoKM
鏖	aoL
骜	aoM
驁	aoMM
眑	aoMN
鼇	aoMO
媪	aoN
媼	aoNM
嫯	aoNN
鷔	aoNO
嗷	aoO
囂	aoOM
嗸	aoON
磝	aoPM
獒	aoQ
獓	aoQM
岙	aoS
嶴	aoSM
岰	aoSN
嶅	aoSO
坳	aoT
垇	aoTM
墺	aoTN
艹	aoU
芺	aoUM
蔜	aoUN
傲	aoV
敖	aoW
璈	aoWM
懊	aoX
慠	aoXM
翱	aoY
鳌	aoYB
翺	aoYM
鰲	aoYN
謷	aoYO
翶	aoYP
謸	aoYQ
遨	aoZ
醃	aQM
把	baA
拔	baAB
扒	baAC
捌	baAD
抜	baAM
扷	baAN
八	baB
疤	baBB
丷	baBM
皅	baBN
癹	baBO
蚆	baCM
軷	baCN
夿	baDM
灞	baE
爸	baF
颰	baFM
靶	baG
魃	baGB
弝	baGM
炦	baHM
摆	baiA
拜	baiAB
掰	baiAC
捭	baiAD
擘	baiAE
擺	baiAM
拝	baiAN
挀	baiAO
白	baiB
百	baiBB
败	baiBC
贁	baiBM
絔	baiFM
庍	baiGM
稗	baiH
柏	baiI
栢	baiIM
兡	baiKM
襬	baiKN
竡	baiLM
朳	baIM
粨	baiMM
粺	baiMN
柭	baIN
犤	baiNM
呗	baiO
欛	baIOL
唄	baiOM
猈	baiQM
薭	baiUM
伯	baiV
佰	baiVB
敗	baiWM
瓸	baiWN
韛	baiWO
钯	baJ
鈀	baJM
釟	baJN
釛	baJO
笆	baK
耙	baL
胈	baLM
粑	baM
搬	banA
扮	banAB
拌	banAC
扳	banAD
搫	banAM
半	banB
瘢	banBB
癍	banBC
蝂	banCM
螁	banCN
螌	banCO
湴	banEM
绊	banF
阪	banFB
絆	banFM
挷	bangAM
捠	bangAN
搒	bangAO
蚌	bangC
蚄	bangCM
蛖	bangCN
蜯	bangCO
浜	bangE
邦	bangF
绑	bangFB
旁	bangFC
綁	bangFM
邫	bangFN
縍	bangFO
鞤	bangGM
髈	bangGN
稖	bangHM
棒	bangI
榜	bangIB
梆	bangIC
棓	bangIM
帮	bangJ
镑	bangJB
幫	bangJM
鎊	bangJN
幇	bangJO
幚	bangJP
膀	bangL
靽	banGM
磅	bangP
硥	bangPM
牓	bangPN
峀	bangSM
垹	bangTM
塝	bangTN
蒡	bangU
傍	bangV
玤	bangWM
谤	bangY
謗	bangYM
艕	bangZM
秚	banHM
板	banI
柈	banIM
钣	banJ
鈑	banJM
鉡	banJN
褩	banKM
办	banL
朌	banLM
肦	banLN
妭	baNM
粄	banMM
闆	banMN
姅	banNM
鳻	banNN
版	banP
昄	banRM
岅	banSM
坂	banT
坢	banTM
伴	banV
班	banW
斑	banWB
瓪	banWM
攽	banWN
斒	banWO
瓣	banX
辦	banXM
怑	banXN
辬	banXO
颁	banY
頒	banYM
魬	banYN
般	banZ
舨	banZB
跘	banZM
吧	baO
报	baoA
抱	baoAB
包	baoB
宝	baoBB
宀	baoBC
勹	baoBD
叭	baOBL
寶	baoBM
勽	baoBN
宲	baoBO
寚	baoBP
髱	baoBQ
賲	baoBR
寳	baoBS
龅	baoC
齙	baoCM
蚫	baoCN
忁	baoCO
剥	baoD
刨	baoDB
剝	baoDM
瀑	baoE
緥	baoFM
骲	baoGM
爆	baoH
炮	baoHB
煲	baoHC
虣	baoHM
枹	baoIM
铇	baoJM
鉋	baoJN
鑤	baoJO
褒	baoK
褓	baoKB
笣	baoKM
袌	baoKN
裦	baoKO
襃	baoKP
胞	baoL
巼	baOM
靤	baoMM
駂	baoMN
闁	baoMO
鸨	baoN
哱	baONL
鴇	baoNM
媬	baoNN
鳵	baoNO
犦	baoNP
哵	baOO
嚗	baoOM
犳	baoQM
暴	baoR
曝	baoRB
雹	baoRC
曓	baoRM
靌	baoRN
饱	baoS
飽	baoSM
飹	baoSN
堡	baoT
報	baoTM
堢	baoTN
薄	baoU
苞	baoUB
葆	baoUC
菢	baoUM
蕔	baoUN
藵	baoUO
保	baoV
佨	baoVM
儤	baoVN
珤	baoWM
怉	baoXM
窇	baoXN
鲍	baoY
鮑	baoYM
豹	baoZ
孢	baoZB
趵	baoZC
霸	baR
巴	baS
罢	baSB
岜	baSC
罷	baSM
峇	baSN
豝	baSO
鼥	baSP
矲	baSQ
坝	baT
壩	baTM
垻	baTN
芭	baU
茇	baUB
菝	baUC
仈	baVM
玐	baWM
覇	baXM
鲅	baY
鮁	baYM
犮	baYN
叐	baYO
羓	baYP
鲃	baYQ
詙	baYR
鲌	baYS
魞	baYT
鮊	baYU
跋	baZ
跁	baZM
揹	beiAM
北	beiB
贝	beiBB
貝	beiBM
辈	beiC
輩	beiCM
軰	beiCN
蛽	beiCO
陂	beiF
邶	beiFB
郥	beiFM
鄁	beiFN
鞴	beiG
庳	beiGB
鞁	beiGM
骳	beiGN
鞞	beiGO
焙	beiH
杯	beiI
杮	beiIM
柸	beiIN
桮	beiIO
梖	beiIP
棑	beiIQ
椑	beiIR
棓	beiIS
钡	beiJ
鐾	beiJB
鋇	beiJM
鉳	beiJN
被	beiK
褙	beiKB
箄	beiKM
襬	beiKN
背	beiL
臂	beiLB
盃	beiMM
糒	beiMN
鹎	beiN
鵯	beiNM
牬	beiNN
犕	beiNO
呗	beiO
唄	beiOM
碑	beiP
碚	beiPB
狈	beiQ
狽	beiQM
昁	beiRM
卑	beiS
禙	beiSM
蓓	beiU
苝	beiUM
藣	beiUN
倍	beiV
備	beiVM
俻	beiVN
偝	beiVO
偹	beiVP
僃	beiVQ
珼	beiWM
琲	beiWN
悲	beiX
惫	beiXB
悖	beiXC
憊	beiXM
愂	beiXN
誖	beiYM
諀	beiYN
备	beiZ
孛	beiZB
捹	benAM
撪	benAN
贲	benB
賁	benBM
蟦	benCM
奔	benD
夯	benDB
夲	benDM
奙	benDN
泍	benEM
渀	benEN
漰	benEO
揼	bengAM
痭	bengBM
蚌	bengC
蜯	bengCM
奟	bengDM
泵	bengE
绷	bengF
繃	bengFM
絣	bengFN
綳	bengFO
鞛	bengGM
镚	bengJM
鏰	bengJN
體	benGM
閍	bengMM
嘣	bengO
嗙	bengOM
崩	bengS
祊	bengSM
嵭	bengSN
埄	bengTM
埲	bengTN
塴	bengTO
菶	bengUM
伻	bengVM
甏	bengW
琫	bengWM
琣	bengWN
甭	bengY
甮	bengYM
蹦	bengZ
迸	bengZB
逬	bengZM
跰	bengZN
炃	benHM
本	benI
栟	benIM
桳	benIN
楍	benIO
锛	benJ
錛	benJM
笨	benK
犇	benNM
喯	benOM
坌	benT
畚	benTB
坋	benTM
苯	benU
倴	benVM
翉	benYM
逩	benZM
抃	bianAM
揙	bianAN
贬	bianB
髟	bianBB
貶	bianBM
疺	bianBN
蝙	bianC
釆	bianCM
徧	bianCN
卞	bianD
豍	bianDM
汴	bianE
汳	bianEM
编	bianF
匾	bianFB
缏	bianFC
編	bianFM
緶	bianFN
鞭	bianG
弁	bianGB
鞕	bianGM
扁	bianH
煸	bianHB
炞	bianHM
稨	bianHN
覍	bianJM
鍽	bianJN
覵	bianJO
笾	bianK
褊	bianKB
籩	bianKM
箯	bianKN
籓	bianKO
閞	bianMM
糄	bianMN
鴘	bianNM
鶣	bianNN
砭	bianP
碥	bianPB
牑	bianPM
猵	bianQM
獱	bianQN
昪	bianRM
峅	bianSM
苄	bianU
萹	bianUM
藊	bianUN
便	bianV
玣	bianWM
甂	bianWN
辩	bianX
辨	bianXB
辫	bianXC
忭	bianXD
窆	bianXE
辮	bianXM
辯	bianXN
惼	bianXO
辡	bianXP
辧	bianXQ
变	bianY
鳊	bianYB
變	bianYM
鯿	bianYN
諚	bianYO
鯾	bianYP
边	bianZ
遍	bianZB
邊	bianZM
辺	bianZN
変	bianZO
臱	bianZP
艑	bianZQ
邉	bianZR
摽	biaoAM
髟	biaoB
瘭	biaoBB
贆	biaoBM
淲	biaoEM
滮	biaoEN
瀌	biaoEO
飙	biaoF
飚	biaoFB
飑	biaoFC
飆	biaoFM
飈	biaoFN
颮	biaoFO
颩	biaoFP
颷	biaoFQ
飇	biaoFR
飊	biaoFS
灬	biaoH
熛	biaoHM
爂	biaoHN
穮	biaoHO
标	biaoI
杓	biaoIB
標	biaoIM
檦	biaoIN
镖	biaoJ
镳	biaoJB
鏢	biaoJM
鑣	biaoJN
幖	biaoJO
鋲	biaoJP
錶	biaoJQ
表	biaoK
裱	biaoKB
褾	biaoKM
篻	biaoKN
膘	biaoL
脿	biaoLM
膔	biaoLN
麃	biaoLO
臕	biaoLP
骠	biaoM
驃	biaoMM
骉	biaoMN
驫	biaoMO
婊	biaoN
嫑	biaoNM
磦	biaoPM
猋	biaoQM
彪	biaoS
墂	biaoTM
蔈	biaoUM
藨	biaoUN
俵	biaoVM
僄	biaoVN
儦	biaoVO
鳔	biaoY
鰾	biaoYM
諘	biaoYN
謤	biaoYO
比	biB
毕	biBB
鼻	biBC
匕	biBD
毙	biBE
痹	biBF
贲	biBG
毖	biBH
賁	biBM
匂	biBN
皀	biBO
疕	biBP
疪	biBQ
皕	biBR
貱	biBS
赑	biBT
痺	biBU
髲	biBV
贔	biBW
彼	biC
蜌	biCM
螕	biCN
夶	biDM
豍	biDN
奰	biDO
泌	biE
瘪	bieB
濞	biEBL
癟	bieBM
滗	biEC
蛂	bieCM
徶	bieCN
蟞	bieCO
别	bieD
別	bieDM
彆	bieGM
龞	bieGN
柭	bieIM
柲	bieIN
襒	bieKM
潷	biEM
鼈	bieMM
沘	biEN
湢	biEO
咇	bieOM
滭	biEP
莂	bieUM
虌	bieUN
憋	bieX
鳖	bieY
鱉	bieYM
蹩	bieZ
鄙	biF
陛	biFB
紕	biFM
邲	biFN
旇	biFO
紴	biFP
聛	biFQ
鄪	biFR
綼	biFS
縪	biFT
鄨	biFU
繴	biFV
弊	biG
庇	biGB
弼	biGC
髀	biGD
庳	biGE
弻	biGM
彃	biGN
廦	biGO
鞞	biGP
鞸	biGQ
魓	biGR
秘	biH
秕	biHB
煏	biHM
稫	biHN
熚	biHO
朼	biIM
柲	biIN
柀	biIO
梐	biIP
楅	biIQ
榌	biIR
币	biJ
铋	biJB
幣	biJM
鉍	biJN
幤	biJO
觱	biJP
鏎	biJQ
鎞	biJR
鐴	biJS
笔	biK
裨	biKB
篦	biKC
筚	biKD
箅	biKE
襞	biKF
筆	biKM
篳	biKN
笓	biKO
袐	biKP
箆	biKQ
箄	biKR
襅	biKS
襣	biKT
臂	biL
肶	biLM
胇	biLN
腷	biLO
闭	biM
睥	biMB
閉	biMM
闬	biMN
毞	biMO
粊	biMP
粃	biMQ
閈	biMR
閇	biMS
毴	biMT
睤	biMU
閟	biMV
駜	biMW
驆	biMX
鼊	biMY
婢	biN
摈	binA
擯	binAM
宾	binB
鬓	binBB
妣	biNBL
賓	binBM
鬢	binBN
髩	binBO
賔	binBP
鬂	binBQ
嬖	biNC
蠙	binCM
殡	binD
殯	binDM
滨	binE
濒	binEB
濱	binEM
瀕	binEN
汃	binEO
濵	binEP
缤	binF
繽	binFM
邠	binFN
髌	binG
摒	bingA
抦	bingAM
掤	bingAN
兵	bingB
并	bingBB
冰	bingBC
病	bingBD
冫	bingBE
並	bingBM
寎	bingBN
蛃	bingCM
氷	bingEM
邴	bingF
綆	bingFM
陃	bingFN
絣	bingFO
幷	bingGM
庰	bingGN
鞆	bingGO
鞞	bingGP
鞸	bingGQ
秉	bingH
炳	bingHB
丙	bingHC
稟	bingHM
柄	bingI
槟	bingIB
檳	bingIM
栤	bingIN
栟	bingIO
梹	bingIP
棅	bingIQ
鈵	bingJM
鉼	bingJN
鋲	bingJO
竝	bingLM
髕	binGM
眪	bingMM
屏	bingP
屛	bingPM
昞	bingRM
昺	bingRN
靐	bingRO
饼	bingS
禀	bingSB
餅	bingSM
餠	bingSN
垪	bingTM
苪	bingUM
仌	bingVM
仒	bingVN
併	bingVO
倂	bingVP
偋	bingVQ
傡	bingVR
琕	bingWM
怲	bingXM
窉	bingXN
誁	bingYM
鮩	bingYN
虨	binHM
槟	binI
檳	binIM
梹	binIN
椕	binIO
镔	binJ
鑌	binJM
膑	binL
臏	binLM
妼	biNM
娝	biNN
嬶	biNO
鵖	biNP
砏	binPM
鶝	biNQ
鷝	biNR
霦	binRM
彬	binS
豳	binSB
鷩	biNSL
豩	binSM
傧	binV
儐	binVM
斌	binW
玢	binWB
瑸	binWM
璸	binWN
頻	binYM
顮	binYN
哔	biO
吡	biOB
嗶	biOM
咇	biON
啚	biOO
碧	biP
屄	biPM
狴	biQ
獙	biQM
獘	biQN
朇	biRM
祕	biSM
崥	biSN
禆	biSO
飶	biSP
罼	biSQ
饆	biSR
壁	biT
畀	biTB
畢	biTM
坒	biTN
畁	biTO
畐	biTP
堛	biTQ
蔽	biU
薜	biUB
荜	biUC
蓖	biUD
芘	biUE
萆	biUF
荸	biUG
蓽	biUM
苾	biUN
萞	biUO
俾	biV
佖	biVM
佊	biVN
偪	biVO
璧	biW
敝	biWB
斃	biWM
珌	biWN
韠	biWO
必	biX
辟	biXB
愎	biXC
怭	biXM
怶	biXN
愊	biXO
馝	biXP
诐	biYM
翍	biYN
詖	biYO
鮅	biYP
鲾	biYQ
鰏	biYR
避	biZ
逼	biZB
跸	biZC
舭	biZD
蹕	biZM
迊	biZN
貏	biZO
躃	biZP
躄	biZQ
播	boA
搏	boAB
拨	boAC
擘	boAD
撥	boAM
挬	boAN
卜	boB
魄	boBB
癶	boBM
皪	boBN
彴	boCM
蚾	boCN
剥	boD
剝	boDM
殕	boDN
波	boE
泊	boEB
渤	boEC
浡	boEM
淿	boEN
溊	boEO
缽	boFM
郣	boFN
紴	boFO
瓝	boGM
瓟	boGN
髆	boGO
髉	boGP
秡	boHM
煿	boHN
穛	boHO
柏	boI
檗	boIB
柭	boIM
栢	boIN
桲	boIO
榑	boIP
檘	boIQ
欂	boIR
钵	boJ
帛	boJB
钹	boJC
铂	boJD
鉑	boJM
鈸	boJN
鉢	boJO
镈	boJP
鋍	boJQ
鎛	boJR
鑮	boJS
箔	boK
簸	boKB
袯	boKM
袹	boKN
襏	boKO
簙	boKP
襮	boKQ
脖	boL
勃	boLB
膊	boLC
肑	boLM
胉	boLN
驳	boM
駁	boMM
盋	boMN
駮	boMO
糪	boMP
驋	boMQ
鹁	boN
鵓	boNM
犦	boNN
啵	boO
哱	boOM
噃	boON
嚗	boOO
礴	boP
砵	boPM
碆	boPN
牔	boPO
磻	boPP
礡	boPQ
狛	boQM
猼	boQN
博	boS
饽	boSB
餑	boSM
馎	boSN
嶓	boSO
餺	boSP
亳	boT
壆	boTM
薄	boU
菠	boUB
蔔	boUM
蘗	boUN
苩	boUO
萡	boUP
葧	boUQ
伯	boV
仢	boVM
侼	boVN
僰	boVO
僠	boVP
玻	boW
愽	boXM
馛	boXN
馞	boXO
懪	boXP
詙	boYM
鲌	boYN
誖	boYO
鮊	boYP
謈	boYQ
譒	boYR
鱍	boYS
舶	boZ
跛	boZB
孛	boZC
踣	boZD
艊	boZM
孹	boZN
蹳	boZO
捕	buA
抪	buAM
捗	buAN
捬	buAO
卜	buB
轐	buCM
部	buF
郶	buFM
巭	buGM
庯	buGN
廍	buGO
不	buH
柨	buIM
布	buJ
钚	buJB
钸	buJC
鈈	buJM
鈽	buJN
錻	buJO
补	buK
簿	buKB
補	buKM
箁	buKN
篰	buKO
勏	buLM
兺	bunBM
婄	buNM
鳪	buNN
鵏	buNO
鸔	buNP
卟	buO
哺	buOB
吥	buOM
咘	buON
醭	buQ
晡	buR
峬	buSM
餔	buSN
餢	buSO
埠	buT
埔	buTB
堡	buTC
埗	buTM
蔔	buUM
荹	buUN
蔀	buUO
佈	buVM
瓿	buW
怖	buX
悑	buXM
誧	buYM
鯆	buYN
步	buZ
逋	buZB
歨	buZM
歩	buZN
踄	buZO
擦	caA
拆	caAB
攃	caAM
扐	caiAM
採	caiAN
揌	caiAO
财	caiB
財	caiBM
宷	caiBN
寀	caiBO
采	caiC
綵	caiFM
縩	caiFN
纔	caiFO
戝	caiGM
才	caiH
材	caiI
棌	caiIM
裁	caiK
睬	caiM
婇	caiNM
啋	caiOM
猜	caiQ
彩	caiS
埰	caiTM
菜	caiU
蔡	caiUB
倸	caiVM
偲	caiVN
踩	caiZ
跴	caiZM
摻	canAM
摲	canAN
蚕	canC
蠶	canCM
蝅	canCN
蠺	canCO
残	canD
殘	canDM
湌	canEM
澯	canEN
凔	cangBM
賶	cangBN
螥	cangCM
沧	cangE
滄	cangEM
濸	cangEN
匨	cangFM
臧	cangG
欌	cangIM
鑶	cangJM
篬	cangKM
鸧	cangNM
鶬	cangNN
獊	cangQM
嵢	cangSM
藏	cangU
苍	cangUB
蒼	cangUM
仓	cangV
伧	cangVB
倉	cangVM
傖	cangVN
仺	cangVO
玱	cangWM
瑲	cangWN
舱	cangZ
艙	cangZM
灿	canH
黪	canHB
燦	canHM
黲	canHN
穇	canHO
爘	canHP
鏒	canJM
篸	canKM
粲	canM
骖	canMB
驂	canMM
嬠	canNM
喰	canOM
嘇	canON
囋	canOO
孱	canP
朁	canRM
参	canS
餐	canSB
參	canSM
飡	canSN
叄	canSO
叅	canSP
飱	canSQ
薒	canUM
傪	canVM
儏	canVN
璨	canW
惨	canX
惭	canXB
慚	canXM
慘	canXN
慙	canXO
憯	canXP
謲	canYM
嚓	caO
操	caoA
撡	caoAM
螬	caoC
漕	caoE
鄵	caoFM
鼜	caoGM
槽	caoI
鏪	caoJM
鏕	caoJN
褿	caoKM
襙	caoKN
屮	caoL
糙	caoM
囃	caOML
騲	caoMM
嘈	caoO
曹	caoR
肏	caoRM
曺	caoRN
嶆	caoSM
墽	caoTM
草	caoU
艹	caoUB
艸	caoUM
蓸	caoUN
傮	caoVM
愺	caoXM
慅	caoXN
慒	caoXO
懆	caoXP
艚	caoZ
礤	caP
礸	caPM
遪	caZM
拺	ceAM
厕	ceC
厠	ceCM
夨	ceDM
测	ceE
測	ceEM
廁	ceGM
策	ceK
笧	ceKM
筴	ceKN
筞	ceKO
箣	ceKP
簎	ceKQ
粣	ceMM
涔	cenE
汵	cenEM
橧	cengIM
竲	cengLM
驓	cengMM
噌	cengO
层	cengP
層	cengPM
曾	cengR
曽	cengRM
嶒	cengSM
蹭	cengZ
穇	cenHM
梣	cenIM
笒	cenKM
篸	cenKN
参	cenS
岑	cenSB
參	cenSM
叄	cenSN
叅	cenSO
嵾	cenSP
埁	cenTM
册	ceP
冊	ceTM
畟	ceTN
荝	ceUM
萗	ceUN
萴	ceUO
蓛	ceUP
侧	ceV
側	ceVM
敇	ceWM
恻	ceX
惻	ceXM
憡	ceXN
插	chaA
搽	chaAB
扱	chaAM
扠	chaAN
挿	chaAO
捈	chaAP
揷	chaAQ
摖	chaAR
察	chaB
刹	chaD
剎	chaDM
汊	chaE
紁	chaFM
差	chaG
靫	chaGM
秅	chaHM
查	chaI
拆	chaiA
杈	chaIB
瘥	chaiBL
檫	chaIC
虿	chaiCL
蠆	chaiCM
槎	chaID
楂	chaIE
差	chaiG
柴	chaiI
钗	chaiJ
釵	chaiJM
袃	chaiKM
肞	chaiLM
査	chaIM
梌	chaIN
喍	chaiOM
囆	chaiON
犲	chaiQM
祡	chaiSM
芆	chaiUM
茝	chaiUN
侪	chaiV
儕	chaiVM
訍	chaiYM
豺	chaiZ
锸	chaJ
镲	chaJB
鍤	chaJM
鑔	chaJN
臿	chaJO
銟	chaJP
鎈	chaJQ
衩	chaK
姹	chaN
搀	chanA
掺	chanAB
摻	chanAM
攙	chanAN
摲	chanAO
摌	chanAP
单	chanB
冁	chanBB
毚	chanBM
蝉	chanC
蟾	chanCB
蟬	chanCM
螹	chanCN
刬	chanDM
剗	chanDN
剷	chanDO
劖	chanDP
潺	chanE
澶	chanEB
浐	chanEM
湹	chanEN
滻	chanEO
潹	chanEP
瀍	chanEQ
瀺	chanER
灛	chanES
缠	chanF
纏	chanFM
斺	chanFN
緂	chanFO
緾	chanFP
鄽	chanFQ
繟	chanFR
酁	chanFS
繵	chanFT
纒	chanFU
廛	chanG
鬯	changB
长	changC
厂	changCB
徜	changCC
長	changCM
镸	changCN
兏	changCO
厰	changCP
蟐	changCQ
淐	changEM
廠	changGM
甞	changGN
鼚	changGO
焻	changHM
椙	changIM
常	changJ
锠	changJM
鋹	changJN
鋿	changJO
錩	changJP
裳	changK
裮	changKM
肠	changL
畅	changLB
腸	changLM
膓	changLN
氅	changM
阊	changMB
韂	chanGML
閶	changMM
闛	changMN
嫦	changN
娼	changNB
唱	changO
嘗	changOM
嚐	changON
猖	changQ
昌	changR
昶	changRB
暢	changRM
场	changT
場	changTM
塲	changTN
畼	changTO
苌	changU
菖	changUB
萇	changUM
偿	changV
倡	changVB
倘	changVC
伥	changVD
償	changVM
倀	changVN
仧	changVO
仩	changVP
僘	changVQ
敞	changW
玚	changWM
瓺	changWN
琩	changWO
瑒	changWP
瑺	changWQ
韔	changWR
尝	changX
怅	changXB
惝	changXC
悵	changXM
鲳	changY
鯧	changYM
誯	changYN
鲿	changYO
鱨	changYP
煘	chanHM
燀	chanHN
梴	chanIM
棎	chanIN
欃	chanIO
铲	chanJ
觇	chanJB
鏟	chanJM
覘	chanJN
鋋	chanJO
幝	chanJP
鋓	chanJQ
幨	chanJR
镵	chanJS
鑱	chanJT
裧	chanKM
簅	chanKN
襜	chanKO
丳	chanLM
阐	chanM
骣	chanMB
奼	chaNML
闡	chanMM
驏	chanMN
閳	chanMO
婵	chanN
嬋	chanNM
單	chanOM
囅	chanON
啴	chanOO
嘽	chanOP
嚵	chanOQ
孱	chanP
羼	chanPB
硟	chanPM
磛	chanPN
獑	chanQM
醦	chanQN
旵	chanRM
馋	chanS
禅	chanSB
產	chanSM
嶄	chanSN
饞	chanSO
禪	chanSP
産	chanSQ
嶃	chanSR
嵼	chanSS
巉	chanST
产	chanT
壥	chanTM
蒇	chanU
蕆	chanUM
苂	chanUN
僝	chanVM
儃	chanVN
儳	chanVO
忏	chanX
懺	chanXM
懴	chanXN
颤	chanY
谄	chanYB
谗	chanYC
顫	chanYM
讒	chanYN
諂	chanYO
誗	chanYP
譂	chanYQ
讇	chanYR
躔	chanZ
辿	chanZM
艬	chanZN
嚓	chaO
抄	chaoA
摷	chaoAM
喳	chaOB
巢	chaoC
巣	chaoCM
轈	chaoCN
剿	chaoD
劋	chaoDM
潮	chaoE
漅	chaoEM
绰	chaoF
綽	chaoFM
鄛	chaoFN
弨	chaoGM
炒	chaoH
焯	chaoHB
焣	chaoHM
煼	chaoHN
槱	chaoIM
樔	chaoIN
钞	chaoJ
鈔	chaoJM
觘	chaoJN
朝	chaoL
耖	chaoLB
勦	chaoLM
嗏	chaOM
眧	chaoMM
粆	chaoMN
鼌	chaoMO
麨	chaoMP
鼂	chaoMQ
吵	chaoO
嘲	chaoOB
牊	chaoPM
欩	chaoQM
晁	chaoR
禉	chaoSM
罺	chaoSN
巐	chaoSO
仦	chaoVM
仯	chaoVN
怊	chaoX
窲	chaoXM
窼	chaoXN
訬	chaoYM
謿	chaoYN
超	chaoZ
碴	chaP
猹	chaQ
岔	chaS
馇	chaSB
餷	chaSM
嵖	chaSN
垞	chaTM
疀	chaTN
茶	chaU
茬	chaUB
芆	chaUM
仛	chaVM
侘	chaVN
偛	chaVO
叉	chaY
诧	chaYB
詫	chaYM
詧	chaYN
艖	chaZM
蹅	chaZN
撤	cheA
扯	cheAB
掣	cheAC
揊	cheAM
撦	cheAN
摰	cheAO
车	cheC
彻	cheCB
車	cheCM
徹	cheCN
蛼	cheCO
奲	cheDM
澈	cheE
聅	cheFM
烢	cheHM
烲	cheHN
焎	cheHO
爡	cheHP
屮	cheL
勶	cheLM
瞮	cheMM
抻	chenA
捵	chenAM
揨	chenAN
宸	chenB
疢	chenBM
瘎	chenBN
賝	chenBO
瘨	chenBP
贂	chenBQ
臣	chenC
辰	chenCB
龀	chenCC
齔	chenCM
軙	chenCN
齓	chenCO
螴	chenCP
沉	chenE
沈	chenEB
陈	chenF
郴	chenFB
陳	chenFM
綝	chenFN
承	chengA
撑	chengAB
搶	chengAM
撐	chengAN
挰	chengAO
掁	chengAP
揨	chengAQ
摚	chengAR
撜	chengAS
凈	chengBM
宬	chengBN
蛏	chengC
蟶	chengCM
徎	chengCN
赪	chengCO
赬	chengCP
澄	chengE
氶	chengEM
泟	chengEN
洆	chengEO
浾	chengEP
浧	chengEQ
淨	chengER
溗	chengES
澂	chengET
瀓	chengEU
阷	chengFM
郕	chengFN
絾	chengFO
緽	chengFP
罉	chengFQ
成	chengG
庱	chengGM
程	chengH
称	chengHB
丞	chengHC
秤	chengHD
稱	chengHM
穪	chengHN
橙	chengI
柽	chengIB
枨	chengIC
棖	chengIM
檉	chengIN
朾	chengIO
棦	chengIP
椉	chengIQ
橖	chengIR
橕	chengIS
檙	chengIT
铖	chengJ
铛	chengJB
鋮	chengJM
鐺	chengJN
鎗	chengJO
鏿	chengJP
鐣	chengJQ
裎	chengK
筬	chengKM
塍	chengL
脭	chengLM
骋	chengM
盛	chengMB
瞠	chengMC
騁	chengMM
睈	chengMN
矃	chengMO
騬	chengMP
娍	chengNM
呈	chengO
乘	chengP
乗	chengPM
碀	chengPN
酲	chengQ
靗	chengQM
晿	chengRM
峸	chengSM
饓	chengSN
城	chengT
埕	chengTB
埩	chengTM
堘	chengTN
塖	chengTO
畻	chengTP
荿	chengUM
侱	chengVM
偁	chengVN
僜	chengVO
珹	chengWM
琤	chengWN
珵	chengWO
惩	chengX
懲	chengXM
悜	chengXN
窚	chengXO
憆	chengXP
憕	chengXQ
竀	chengXR
诚	chengY
誠	chengYM
牚	chengYN
頳	chengYO
鯎	chengYP
逞	chengZ
爯	chengZM
称	chenH
稱	chenHM
烥	chenHN
煁	chenHO
穪	chenHP
榇	chenI
櫬	chenIM
栕	chenIN
桭	chenIO
梣	chenIP
棽	chenIQ
樄	chenIR
鈂	chenJM
鍖	chenJN
衬	chenK
襯	chenKM
肜	chenL
麎	chenLM
瞋	chenMM
鷐	chenNM
嗔	chenO
嚫	chenOM
碜	chenP
磣	chenPM
硶	chenPN
醦	chenQM
晨	chenR
霃	chenRM
曟	chenRN
塵	chenTM
墋	chenTN
茞	chenUM
莀	chenUN
莐	chenUO
蔯	chenUP
薼	chenUQ
伧	chenV
傖	chenVM
偁	chenVN
儭	chenVO
琛	chenW
敐	chenWM
敶	chenWN
尘	chenX
忱	chenXB
愖	chenXM
夦	chenXN
谌	chenY
谶	chenYB
諶	chenYM
讖	chenYN
訦	chenYO
諃	chenYP
謓	chenYQ
趁	chenZ
迧	chenZM
爯	chenZN
趻	chenZO
趂	chenZP
跈	chenZQ
踸	chenZR
呫	cheOM
唓	cheON
尺	cheP
砗	chePB
硨	chePM
硩	chePN
坼	cheT
莗	cheUM
伡	cheVM
俥	cheVN
偖	cheVO
頙	cheYM
迠	cheZM
持	chiA
扡	chiAM
抶	chiAN
拸	chiAO
捇	chiAP
摛	chiAQ
攡	chiAR
痴	chiB
匙	chiBB
瘛	chiBC
癡	chiBM
貾	chiBN
痸	chiBO
瘈	chiBP
赤	chiC
齿	chiCB
蚩	chiCC
螭	chiCD
彳	chiCE
齒	chiCM
蚇	chiCN
蚳	chiCO
徲	chiCP
齝	chiCQ
豉	chiD
奓	chiDM
殦	chiDN
池	chiE
沶	chiEM
淔	chiEN
湁	chiEO
漦	chiEP
耻	chiF
絺	chiFM
弛	chiG
魑	chiGB
炽	chiH
熾	chiHM
灻	chiHN
烾	chiHO
黐	chiHP
杘	chiIM
柅	chiIN
樆	chiIO
斥	chiJ
卶	chiJM
鉓	chiJN
銐	chiJO
鉹	chiJP
鍉	chiJQ
笞	chiK
褫	chiKB
篪	chiKC
竾	chiKM
袳	chiKN
筂	chiKO
袲	chiKP
裭	chiKQ
箎	chiKR
箈	chiKS
肔	chiLM
勅	chiLN
胣	chiLO
勑	chiLP
胵	chiLQ
耛	chiLR
腟	chiLS
驰	chiM
眵	chiMB
馳	chiMM
粚	chiMN
瞝	chiMO
麶	chiMP
鸱	chiN
媸	chiNB
鴟	chiNM
妛	chiNN
鵄	chiNO
鶒	chiNP
鶗	chiNQ
鶙	chiNR
鷘	chiNS
吃	chiO
嗤	chiOB
哧	chiOC
叱	chiOD
啻	chiOE
叺	chiOM
呎	chiON
喫	chiOO
噄	chiOP
噭	chiOQ
尺	chiP
硳	chiPM
狋	chiQM
欼	chiQN
雴	chiRM
饬	chiS
飭	chiSM
岻	chiSN
彨	chiSO
饎	chiSP
彲	chiSQ
墀	chiT
坻	chiTB
垑	chiTM
茌	chiU
荎	chiUM
菭	chiUN
侈	chiV
傺	chiVB
伬	chiVM
佁	chiVN
侙	chiVO
俿	chiVP
敕	chiW
瓻	chiWM
恥	chiXM
恜	chiXN
憏	chiXO
慗	chiXP
慸	chiXQ
懘	chiXR
翅	chiY
翄	chiYM
訵	chiYN
誃	chiYO
翤	chiYP
誺	chiYQ
翨	chiYR
謘	chiYS
迟	chiZ
踟	chiZB
遲	chiZM
迡	chiZN
歭	chiZO
赿	chiZP
歯	chiZQ
遅	chiZR
跢	chiZS
遟	chiZT
遫	chiZU
趩	chiZV
邌	chiZW
揰	chongAM
摏	chongAN
冲	chongB
宠	chongBB
寵	chongBM
痋	chongBN
虫	chongC
蟲	chongCM
蝩	chongCN
衝	chongCO
徸	chongCP
沖	chongEM
浺	chongEN
漴	chongEO
隀	chongFM
緟	chongFN
种	chongH
爞	chongHM
铳	chongJ
舂	chongJB
銃	chongJM
褈	chongKM
嘃	chongOM
重	chongP
崇	chongS
崈	chongSM
罿	chongSN
充	chongT
埫	chongTM
茺	chongU
珫	chongWM
忡	chongX
憧	chongXB
憃	chongXM
翀	chongYM
艟	chongZ
蹖	chongZM
抽	chouA
掫	chouAM
搊	chouAN
瘳	chouB
皗	chouBM
殠	chouDM
绸	chouF
綢	chouFM
紬	chouFN
絒	chouFO
魗	chouGM
稠	chouH
丒	chouHM
燽	chouHN
杽	chouIM
杻	chouIN
栦	chouIO
梼	chouIP
椆	chouIQ
檮	chouIR
帱	chouJ
幬	chouJM
筹	chouK
籌	chouKM
裯	chouKN
篘	chouKO
瞅	chouM
盩	chouMM
矁	chouMN
牰	chouNM
婤	chouNN
嬦	chouNO
犨	chouNP
犫	chouNQ
吜	chouOM
嚋	chouON
酬	chouQ
醜	chouQM
酧	chouQN
醔	chouQO
醻	chouQP
畴	chouT
疇	chouTM
畤	chouTN
菗	chouUM
薵	chouUN
仇	chouV
丑	chouVB
俦	chouVC
儔	chouVM
偢	chouVN
愁	chouX
惆	chouXB
怞	chouXM
懤	chouXN
讎	chouYM
诪	chouYN
詶	chouYO
鮘	chouYP
譸	chouYQ
讐	chouYR
臭	chouZ
踌	chouZB
雠	chouZC
躊	chouZM
遚	chouZN
臰	chouZO
跾	chouZP
雔	chouZQ
雦	chouZR
搐	chuA
揣	chuaiA
搋	chuaiAB
膪	chuaiL
膗	chuaiLM
啜	chuaiO
嘬	chuaiOB
欼	chuaiQM
踹	chuaiZ
摴	chuAM
摢	chuAN
賗	chuanBM
川	chuanC
巛	chuanCB
輲	chuanCM
剶	chuanDM
汌	chuanEM
摐	chuangAM
疮	chuangB
瘡	chuangBM
创	chuangD
創	chuangDM
刅	chuangDN
刱	chuangDO
剏	chuangDP
剙	chuangDQ
床	chuangG
橦	chuangIM
幢	chuangJ
朣	chuangLM
闯	chuangM
闖	chuangMM
喠	chuangOM
噇	chuangON
牀	chuangPM
牎	chuangPN
牕	chuangPO
磢	chuangPP
傸	chuangVM
窗	chuangX
怆	chuangXB
愴	chuangXM
窓	chuangXN
窻	chuangXO
椽	chuanI
椯	chuanIM
钏	chuanJ
釧	chuanJM
篅	chuanKM
串	chuanL
膞	chuanLM
鶨	chuanNM
喘	chuanO
氚	chuanQ
猭	chuanQM
歂	chuanQN
暷	chuanRM
堾	chuanTM
荈	chuanUM
传	chuanV
傳	chuanVM
僢	chuanVN
玔	chuanWM
圌	chuanWN
瑏	chuanWO
穿	chuanX
舛	chuanXB
船	chuanZ
遄	chuanZB
舡	chuanZC
舩	chuanZM
踳	chuanZN
欻	chuaQM
厨	chuC
蜍	chuCB
蟵	chuCM
齣	chuCN
齭	chuCO
齼	chuCP
初	chuD
刍	chuDB
滁	chuE
泏	chuEM
滀	chuEN
濋	chuEO
除	chuF
绌	chuFB
絀	chuFM
鄐	chuFN
廚	chuGM
黜	chuH
亍	chuHB
處	chuHM
炪	chuHN
楚	chuI
捶	chuiA
搥	chuiAM
楮	chuIB
杵	chuIC
橱	chuID
樗	chuIE
陲	chuiF
缍	chuiFB
炊	chuiH
椎	chuiI
槌	chuiIB
棰	chuiIC
桘	chuiIM
锤	chuiJ
錘	chuiJM
鎚	chuiJN
箠	chuiKM
腄	chuiLM
櫥	chuIM
椘	chuIN
吹	chuiO
榋	chuIOL
垂	chuiP
橻	chuIPL
硾	chuiPM
檚	chuIQ
櫉	chuIR
櫖	chuIS
埀	chuiTM
菙	chuiUM
倕	chuiVM
圌	chuiWM
惙	chuiXM
顀	chuiYM
龡	chuiYN
触	chuJ
锄	chuJB
鋤	chuJM
觸	chuJN
処	chuJO
鉏	chuJP
斶	chuJQ
幮	chuJR
出	chuK
褚	chuKB
篨	chuKM
竌	chuLM
竐	chuLN
耝	chuLO
耡	chuLP
臅	chuLQ
閦	chuMM
賰	chunBM
蠢	chunC
蝽	chunCB
輴	chunCM
淳	chunE
浱	chunEM
湻	chunEN
滣	chunEO
漘	chunEP
纯	chunF
純	chunFM
陙	chunFN
椿	chunI
杶	chunIM
槆	chunIN
橁	chunIO
櫄	chunIP
錞	chunJM
箺	chunKM
脣	chunLM
膞	chunLN
媰	chuNM
睶	chunMM
鹑	chunN
犓	chuNNL
鶉	chunNM
犉	chunNN
媋	chunNO
鶞	chunNP
唇	chunO
鶵	chuNOL
醇	chunQ
醕	chunQM
春	chunR
旾	chunRM
暙	chunRN
堾	chunTM
莼	chunU
蒓	chunUM
芚	chunUN
萅	chunUO
萶	chunUP
蓴	chunUQ
偆	chunVM
瑃	chunWM
惷	chunXM
鯙	chunYM
鰆	chunYN
拺	chuoAM
擉	chuoAN
辍	chuoC
龊	chuoCB
輟	chuoCM
齪	chuoCN
涰	chuoEM
绰	chuoF
綽	chuoFM
繛	chuoFN
戳	chuoG
鏃	chuoJM
鋜	chuoJN
鑡	chuoJO
箹	chuoKM
嘼	chuOM
娕	chuoNM
娖	chuoNN
婼	chuoNO
婥	chuoNP
孎	chuoNQ
啜	chuoO
吷	chuoOM
哾	chuoON
嚽	chuoOO
磭	chuoPM
酫	chuoQM
歠	chuoQN
餟	chuoSM
惙	chuoXM
踔	chuoZ
辶	chuoZB
辵	chuoZM
逴	chuoZN
踀	chuoZO
趠	chuoZP
础	chuP
礎	chuPM
欪	chuQM
歜	chuQN
矗	chuS
岀	chuSM
豖	chuSN
豠	chuSO
禇	chuSP
畜	chuT
埱	chuTM
芻	chuUM
菆	chuUN
蒢	chuUO
蒭	chuUP
藸	chuUQ
储	chuV
儲	chuVM
俶	chuVN
傗	chuVO
儊	chuVP
敊	chuWM
珿	chuWN
琡	chuWO
璴	chuWP
怵	chuX
憷	chuXB
懨	chuXM
慉	chuXN
諔	chuYM
处	chuZ
雏	chuZB
躇	chuZC
蹰	chuZD
雛	chuZM
躕	chuZN
趎	chuZO
貙	chuZP
赐	ciB
兹	ciBB
疵	ciBC
賜	ciBM
皉	ciBN
蛓	ciCM
螆	ciCN
蠀	ciCO
齹	ciCP
刺	ciD
刾	ciDM
泚	ciEM
濨	ciEN
絘	ciFM
縒	ciFN
差	ciG
庛	ciGM
骴	ciGN
髊	ciGO
朿	ciIM
柌	ciIN
栨	ciIO
糍	ciM
鹚	ciN
鶿	ciNM
嬨	ciNN
鴜	ciNO
鷀	ciNP
呰	ciOM
啙	ciON
磁	ciP
礠	ciPM
次	ciQ
祠	ciS
飺	ciSM
餈	ciSN
垐	ciTM
茨	ciU
茈	ciUB
茦	ciUM
莿	ciUN
薋	ciUO
伺	ciV
乲	ciVM
佌	ciVN
佽	ciVO
偨	ciVP
瓷	ciW
珁	ciWM
玼	ciWN
甆	ciWO
辞	ciX
慈	ciXB
辭	ciXM
辝	ciXN
辤	ciXO
词	ciY
詞	ciYM
鮆	ciYN
此	ciZ
雌	ciZB
趀	ciZM
跐	ciZN
匆	congB
賩	congBM
賨	congBN
從	congCM
徔	congCN
従	congCO
徖	congCP
蟌	congCQ
淙	congE
潀	congEM
潈	congEN
漗	congEO
漎	congEP
潨	congEQ
灇	congER
聪	congF
聰	congFM
聡	congFN
聦	congFO
繱	congFP
丛	congH
焧	congHM
熜	congHN
爜	congHO
枞	congI
樅	congIM
棇	congIN
楤	congIO
樬	congIP
樷	congIQ
欉	congIR
錝	congJM
鍯	congJN
鏓	congJO
鏦	congJP
篵	congKM
骢	congM
驄	congMM
瞛	congMN
騘	congMO
婃	congNM
囱	congP
碂	congPM
暰	congRM
葱	congU
苁	congUB
蔥	congUM
蓯	congUN
茐	congUO
藂	congUP
从	congV
琮	congW
璁	congWB
囪	congWM
瑽	congWN
忩	congXM
怱	congXN
悤	congXO
悰	congXP
愡	congXQ
慒	congXR
憁	congXS
叢	congYM
誴	congYN
謥	congYO
孮	congZM
凑	couB
辏	couC
輳	couCM
湊	couEM
楱	couI
腠	couL
傶	couVM
玼	couWM
攒	cuanA
撺	cuanAB
攢	cuanAM
攛	cuanAN
攅	cuanAO
殩	cuanDM
汆	cuanE
濽	cuanEM
灒	cuanEN
爨	cuanH
熶	cuanHM
穳	cuanHN
櫕	cuanIM
欑	cuanIN
镩	cuanJ
鑹	cuanJM
鋑	cuanJN
篡	cuanK
簒	cuanKM
巑	cuanSM
菆	cuanUM
窜	cuanX
竄	cuanXM
窽	cuanXN
窾	cuanXO
蹿	cuanZ
躥	cuanZM
瘄	cuBM
瘯	cuBN
徂	cuC
殂	cuD
縬	cuFM
摧	cuiA
瘁	cuiB
疩	cuiBM
凗	cuiBN
皠	cuiBO
淬	cuiE
漼	cuiEM
濢	cuiEN
紣	cuiFM
缞	cuiFN
綷	cuiFO
縗	cuiFP
焠	cuiHM
熣	cuiHN
榱	cuiI
椊	cuiIM
槯	cuiIN
鏙	cuiJM
衰	cuiK
襊	cuiKM
脆	cuiL
脃	cuiLM
脺	cuiLN
膵	cuiLO
膬	cuiLP
臎	cuiLQ
粹	cuiM
毳	cuiMB
橻	cuIML
粋	cuiMM
啐	cuiO
啛	cuiOM
磪	cuiPM
獕	cuiQM
崔	cuiS
崒	cuiSM
嵟	cuiSN
墔	cuiTM
萃	cuiU
催	cuiV
伜	cuiVM
倅	cuiVN
璀	cuiW
琗	cuiWM
悴	cuiX
忰	cuiXM
慛	cuiXN
竁	cuiXO
翠	cuiY
翆	cuiYM
顇	cuiYN
趡	cuiZM
觕	cuJM
簇	cuK
脨	cuLM
麁	cuLN
麄	cuLO
麆	cuLP
麤	cuLQ
粗	cuM
鼀	cuMM
拵	cunAM
寸	cunC
刌	cunDM
澊	cunEM
邨	cunFM
村	cunI
竴	cunLM
媨	cuNM
籿	cunMM
吋	cunOM
皴	cunP
膥	cunRM
墫	cunTM
侟	cunVM
忖	cunX
存	cunZ
蹲	cunZB
踆	cunZM
措	cuoA
搓	cuoAB
挫	cuoAC
撮	cuoAD
痤	cuoB
瘥	cuoBB
厝	cuoC
齹	cuoCM
剉	cuoDM
剒	cuoDN
縒	cuoFM
酂	cuoFN
酇	cuoFO
庴	cuoGM
髊	cuoGN
虘	cuoHM
棤	cuoIM
错	cuoJ
锉	cuoJB
錯	cuoJM
銼	cuoJN
鎈	cuoJO
鹾	cuoL
脞	cuoLB
鹺	cuoLM
噈	cuOM
睉	cuoMM
磋	cuoP
醝	cuoQM
嵯	cuoS
矬	cuoSB
嵳	cuoSM
莡	cuoUM
莝	cuoUN
蒫	cuoUO
蓌	cuoUP
蔖	cuoUQ
瑳	cuoWM
諎	cuoYM
蹉	cuoZ
夎	cuoZM
逪	cuoZN
遳	cuoZO
皻	cuPM
醋	cuQ
猝	cuQB
酢	cuQC
卒	cuS
蔟	cuU
促	cuV
怚	cuXM
憱	cuXN
誎	cuYM
顣	cuYN
蹙	cuZ
蹴	cuZB
趨	cuZM
趗	cuZN
踀	cuZO
踧	cuZP
踿	cuZQ
蹵	cuZR
打	daA
搭	daAB
撘	daAM
瘩	daB
匒	daBM
蟽	daCM
大	daD
耷	daDB
剳	daDM
沓	daE
汏	daEM
溚	daEN
繨	daFM
鞑	daG
靼	daGB
韃	daGM
炟	daHM
燵	daHN
贷	daiB
貸	daiBM
貣	daiBN
待	daiC
轪	daiCM
軑	daiCN
軚	daiCO
蚮	daiCP
軩	daiCQ
蝳	daiCR
歹	daiD
大	daiDB
殆	daiDC
歺	daiDM
汏	daiEM
瀻	daiEN
绐	daiF
紿	daiFM
緿	daiFN
戴	daiG
甙	daiGB
廗	daiGM
黛	daiH
黱	daiHM
柋	daiIM
带	daiJ
帶	daiJM
帒	daiJN
帯	daiJO
釱	daiJP
袋	daiK
箉	daiKM
簤	daiKN
襶	daiKO
隸	daiLM
隷	daiLN
駘	daiMM
鴏	daiNM
呆	daiO
呔	daiOB
獃	daiQM
曃	daiRM
霴	daiRN
靆	daiRO
岱	daiS
叇	daiSM
埭	daiT
垈	daiTM
代	daiV
傣	daiVB
侢	daiVM
玳	daiW
瑇	daiWM
怠	daiX
懛	daiXM
詒	daiYM
逮	daiZ
迨	daiZB
跢	daiZM
艜	daiZN
蹛	daiZO
鎝	daJM
鎉	daJN
鐽	daJO
答	daK
褡	daKB
笪	daKC
笚	daKM
龖	daLM
龘	daLN
眔	daMM
妲	daN
担	danA
掸	danAB
撣	danAM
擔	danAN
抌	danAO
撢	danAP
单	danB
疸	danBB
瘅	danBC
赕	danBD
賧	danBM
癉	danBN
髧	danBO
癚	danBP
贉	danBQ
蛋	danC
蜑	danCM
殚	danD
殫	danDM
刐	danDN
淡	danE
澹	danEB
泹	danEM
沊	danEN
澸	danEO
耽	danF
郸	danFB
聃	danFC
鄲	danFM
耼	danFN
紞	danFO
匰	danFP
聸	danFQ
繵	danFR
弹	danG
挡	dangA
擋	dangAM
攩	dangAN
宕	dangB
蟷	dangCM
党	dangE
氹	dangEM
潒	dangEN
澢	dangEO
灙	dangEP
黨	dangHM
档	dangI
檔	dangIM
欓	dangIN
铛	dangJ
鐺	dangJM
裆	dangK
凼	dangKB
襠	dangKM
筜	dangKN
簜	dangKO
簹	dangKP
彈	danGM
瞊	dangMM
盪	dangMN
闣	dangMO
弾	danGN
婸	dangNM
噹	dangOM
砀	dangP
碭	dangPM
礑	dangPN
雼	dangRM
崵	dangSM
嵣	dangSN
場	dangTM
當	dangTN
圵	dangTO
垱	dangTP
壋	dangTQ
荡	dangU
菪	dangUB
蕩	dangUM
蘯	dangUN
偒	dangVM
儅	dangVN
珰	dangWM
瓽	dangWN
璫	dangWO
璗	dangWP
当	dangX
愓	dangXM
谠	dangY
讜	dangYM
譡	dangYN
逿	dangZM
趤	dangZN
艡	dangZO
黕	danHM
燀	danHN
黮	danHO
黵	danHP
柦	danIM
卩	danJ
帎	danJM
觛	danJN
凼	danK
箪	danKB
簞	danKM
衴	danKN
褝	danKO
襌	danKP
胆	danL
膽	danLM
腅	danLN
勯	danLO
眈	danM
馾	danMM
駳	danMN
妉	danNM
媅	danNN
鴠	danNO
啖	danO
單	danOM
呾	danON
唌	danOO
啗	danOP
啿	danOQ
噉	danOR
嘾	danOS
嚪	danOT
石	danP
丹	danPB
砃	danPM
皽	danPN
氮	danQ
狚	danQM
酖	danQN
醈	danQO
旦	danR
霮	danRM
単	danSM
躭	danSN
餤	danSO
禫	danSP
饏	danSQ
亶	danTM
萏	danU
菪	danUB
蓞	danUM
但	danV
儋	danVB
亻	danVC
伔	danVM
僤	danVN
玬	danWM
瓭	danWN
甔	danWO
惮	danX
憚	danXM
惔	danXN
愖	danXO
窞	danXP
憺	danXQ
诞	danY
誕	danYM
訑	danYN
頕	danYO
譂	danYP
疍	danZM
嗒	daO
捣	daoA
搗	daoAM
捯	daoAN
擣	daoAO
哒	daOB
导	daoC
導	daoCM
衜	daoCN
螩	daoCO
衟	daoCP
到	daoD
刀	daoDB
刂	daoDC
纛	daoF
陦	daoFM
絩	daoFN
隝	daoFO
隯	daoFP
稻	daoH
焘	daoHB
燾	daoHM
稲	daoHN
朷	daoIM
梼	daoIN
椡	daoIO
槝	daoIP
檤	daoIQ
檮	daoIR
帱	daoJ
幬	daoJM
釖	daoJN
裯	daoKM
箌	daoKN
盗	daoM
噠	daOML
盜	daoMM
咑	daON
叨	daoO
呾	daOOL
嘄	daoOM
噵	daoON
氘	daoQ
岛	daoS
祷	daoSB
島	daoSM
禱	daoSN
屶	daoSO
禂	daoSP
嶋	daoSQ
嶌	daoSR
嶹	daoSS
軇	daoST
壔	daoTM
菿	daoUM
倒	daoV
儔	daoVM
瓙	daoWM
悼	daoX
忉	daoXB
鱽	daoYM
魛	daoYN
翢	daoYO
翿	daoYP
道	daoZ
蹈	daoZB
辺	daoZM
舠	daoZN
艔	daoZO
亣	daTM
垯	daTN
畗	daTO
畣	daTP
墶	daTQ
荙	daUM
荅	daUN
薘	daUO
怛	daX
憚	daXM
羍	daYM
詚	daYN
达	daZ
達	daZM
迏	daZN
迖	daZO
迚	daZP
逹	daZQ
跶	daZR
躂	daZS
的	deB
得	deC
德	deCB
蚮	deCM
徳	deCN
淂	deEM
底	deG
得	deiC
棏	deIM
嘚	deiOM
锝	deJ
鍀	deJM
脦	deLM
扥	denAM
扽	denAN
登	dengB
豋	dengDM
澄	dengE
澂	dengEM
瀓	dengEN
邓	dengF
鄧	dengFM
隥	dengFN
戥	dengG
灯	dengH
燈	dengHM
櫈	dengIM
凳	dengJ
镫	dengJB
鐙	dengJM
覴	dengJN
等	dengK
簦	dengKB
竳	dengLM
瞪	dengM
嬁	dengNM
噔	dengO
磴	dengP
嶝	dengS
墱	dengTM
僜	dengVM
璒	dengWM
憕	dengXM
蹬	dengZ
艠	dengZM
嘚	deOM
旳	deRM
地	deT
恴	deXM
惪	deXN
悳	deXO
抵	diA
提	diAB
扚	diAM
拞	diAN
掂	dianA
攧	dianAM
典	dianB
癫	dianBB
癜	dianBC
癲	dianBM
痁	dianBN
痶	dianBO
瘨	dianBP
厧	dianCM
蜔	dianCN
齻	dianCO
奠	dianD
丶	dianDB
奌	dianDM
淀	dianE
滇	dianEB
澱	dianEM
阽	dianF
店	dianG
点	dianH
點	dianHM
扂	dianHN
椣	dianIM
槙	dianIN
槇	dianIO
橝	dianIP
橂	dianIQ
钿	dianJ
鈿	dianJM
簟	dianK
驔	dianMM
婰	dianNM
婝	dianNN
嚸	dianOM
殿	dianP
碘	dianPB
磹	dianPM
靛	dianQ
猠	dianQM
電	dianRM
巅	dianS
巔	dianSM
嵮	dianSN
巓	dianSO
电	dianT
垫	dianTB
甸	dianTC
坫	dianTD
墊	dianTM
壂	dianTN
蒧	dianUM
蕇	dianUN
佃	dianV
佔	dianVM
傎	dianVN
玷	dianW
敁	dianWM
琔	dianWN
敟	dianWO
惦	dianX
窴	dianXM
颠	dianY
顛	dianYM
顚	dianYN
踮	dianZ
跕	dianZM
蹎	dianZN
嗲	diaO
掉	diaoA
扚	diaoAM
凋	diaoB
瘹	diaoBM
虭	diaoCM
蛁	diaoCN
刁	diaoD
刟	diaoDM
奝	diaoDN
殦	diaoDO
汈	diaoEM
絩	diaoFM
弔	diaoGM
弴	diaoGN
椆	diaoIM
钓	diaoJ
铞	diaoJB
铫	diaoJC
釣	diaoJM
銱	diaoJN
銚	diaoJO
鈟	diaoJP
鋽	diaoJQ
錭	diaoJR
鑃	diaoJS
簓	diaoKM
掋	diAOL
竨	diaoLM
盄	diaoMM
瞗	diaoMN
鸟	diaoN
鳥	diaoNM
鳭	diaoNN
鵰	diaoNO
吊	diaoO
叼	diaoOB
碉	diaoP
屌	diaoPM
雿	diaoRM
彫	diaoSM
鼦	diaoSN
蓧	diaoUM
藋	diaoUN
伄	diaoVM
琱	diaoWM
窎	diaoXM
窵	diaoXN
调	diaoY
鲷	diaoYB
調	diaoYM
鯛	diaoYN
訋	diaoYO
誂	diaoYP
魡	diaoYQ
鮉	diaoYR
雕	diaoZ
貂	diaoZB
揥	diAP
摕	diAQ
弟	diB
的	diBB
髢	diBM
厎	diCM
彽	diCN
蚳	diCO
軧	diCP
蝃	diCQ
蝭	diCR
螮	diCS
奀	diDM
奃	diDN
滴	diE
揲	dieA
挕	dieAM
涤	diEB
蝶	dieC
軼	dieCM
镻	dieCN
蜨	dieCO
螲	dieCP
殜	dieDM
泆	dieEM
爹	dieF
绖	dieFM
絰	dieFN
瓞	dieG
戜	dieGM
鞢	dieGN
柣	dieIM
楪	dieIN
槢	dieIO
幉	dieJM
褋	dieKM
褺	dieKN
耋	dieL
胅	dieLM
耊	dieLN
滌	diEM
眣	dieMM
眰	dieMN
氎	dieMO
浟	diEN
鴩	dieNM
喋	dieO
渧	diEOL
哋	dieOM
咥	dieON
啑	dieOO
碟	dieP
牒	diePB
牃	diePM
昳	dieRM
曡	dieRN
峌	dieSM
崼	dieSN
嵽	dieSO
堞	dieT
垤	dieTB
疊	dieTM
畳	dieTN
疂	dieTO
疉	dieTP
苵	dieUM
怢	dieXM
恎	dieXN
惵	dieXO
叠	dieY
谍	dieYB
鲽	dieYC
諜	dieYM
鰈	dieYN
詄	dieYO
跌	dieZ
迭	dieZB
蹀	dieZC
臷	dieZM
趃	dieZN
跕	dieZO
跮	dieZP
艓	dieZQ
蹛	dieZR
缔	diF
邸	diFB
締	diFM
阺	diFN
隄	diFO
聜	diFP
底	diG
骶	diGB
弤	diGM
靮	diGN
鞮	diGO
秪	diHM
焍	diHN
棣	diI
柢	diIB
杕	diIM
枤	diIN
枑	diIO
梊	diIP
梑	diIQ
楴	diIR
樀	diIS
帝	diJ
镝	diJB
觌	diJC
鏑	diJM
覿	diJN
釱	diJO
觝	diJP
鉪	diJQ
第	diK
笛	diKB
袛	diKM
篴	diKN
肑	diLM
腣	diLN
睇	diM
籴	diMB
糴	diMM
眱	diMN
馰	diMO
嫡	diN
娣	diNB
掟	dingAM
定	dingB
疔	dingBB
虰	dingCM
鼎	dingD
鼑	dingDM
濎	dingEM
耵	dingF
聢	dingFM
靪	dingGM
丁	dingH
椗	dingIM
钉	dingJ
锭	dingJB
釘	dingJM
錠	dingJN
鋌	dingJO
帄	dingJP
鐤	dingJQ
腚	dingL
盯	dingM
奵	dingNM
叮	dingO
啶	dingOB
碇	dingP
矴	dingPM
碠	dingPN
磸	dingPO
酊	dingQ
饤	dingSM
飣	dingSN
嵿	dingSO
町	dingT
甼	dingTM
艼	dingUM
萣	dingUN
薡	dingUO
仃	dingV
玎	dingW
忊	dingXM
顶	dingY
订	dingYB
訂	dingYM
頂	dingYN
顁	dingYO
牴	diNM
媂	diNN
鸐	diNO
嘀	diO
呧	diOM
哋	diON
唙	diOO
啲	diOP
啇	diOQ
嚁	diOR
砥	diP
碲	diPB
碮	diPM
磾	diPN
狄	diQ
旳	diRM
氐	diS
祗	diSB
岻	diSM
祶	diSN
禘	diSO
嵽	diSP
嶳	diSQ
豴	diSR
地	diT
堤	diTB
坻	diTC
墑	diTM
坘	diTN
坔	diTO
埅	diTP
埊	diTQ
埞	diTR
墆	diTS
墬	diTT
蒂	diU
荻	diUB
颩	diuFM
丟	diuHM
铥	diuJ
銩	diuJM
蓧	diUM
苖	diUN
苐	diUO
丢	diuP
菂	diUPL
菧	diUQ
蔕	diUR
蔐	diUS
蔋	diUT
藡	diUU
低	diV
仾	diVM
俤	diVN
偙	diVO
僀	diVP
敌	diW
敵	diWM
玓	diWN
珶	diWO
甋	diWP
怟	diXM
慸	diXN
诋	diY
翟	diYB
谛	diYC
羝	diYD
詆	diYM
諦	diYN
廸	diYO
頔	diYP
諟	diYQ
鯳	diYR
迪	diZ
递	diZB
遞	diZM
逓	diZN
趆	diZO
遆	diZP
疐	diZQ
遰	diZR
踶	diZS
蹢	diZT
挏	dongAM
揰	dongAN
冻	dongB
凍	dongBM
蝀	dongCM
洞	dongE
涷	dongEM
湩	dongEN
絧	dongFM
戙	dongGM
鼕	dongGN
东	dongH
烔	dongHM
燑	dongHN
栋	dongI
東	dongIM
棟	dongIN
笗	dongKM
箽	dongKN
动	dongL
胴	dongLB
胨	dongLC
動	dongLM
腖	dongLN
勭	dongLO
駧	dongMM
鸫	dongN
鶇	dongNM
姛	dongNN
娻	dongNO
嬞	dongNP
鶫	dongNQ
咚	dongO
硐	dongP
氡	dongQ
狪	dongQM
氭	dongQN
昸	dongRM
霘	dongRN
峒	dongS
岽	dongSB
崠	dongSM
崬	dongSN
垌	dongT
埬	dongTM
墥	dongTN
董	dongU
苳	dongUM
菄	dongUN
蕫	dongUO
侗	dongV
倲	dongVM
働	dongVN
懂	dongX
恫	dongXB
諌	dongYM
鮗	dongYN
鯟	dongYO
冬	dongZ
夂	dongZB
迵	dongZM
抖	douA
痘	douB
蚪	douC
斗	douD
豆	douDB
鬥	douDM
剅	douDN
鬦	douDO
斣	douDP
鬪	douDQ
鬭	douDR
鬬	douDS
兜	douE
瀆	douEM
浢	douEN
兠	douEO
都	douF
陡	douFB
阧	douFM
郖	douFN
枓	douIM
梪	douIN
橷	douIO
钭	douJ
鈄	douJM
鋀	douJN
篼	douK
脰	douLM
毭	douMM
閗	douMN
瞗	douMO
闘	douMP
吋	douOM
吺	douON
唗	douOO
唞	douOP
狵	douQM
酘	douQN
饾	douSM
餖	douSN
畓	douTM
蔸	douU
荳	douUM
乧	douVM
侸	douVN
窦	douX
竇	douXM
读	douY
讀	douYM
逗	douZ
剬	duanDM
耑	duanEM
缎	duanF
緞	duanFM
煅	duanH
椴	duanI
断	duanJ
锻	duanJB
鍛	duanJM
斷	duanJN
鍴	duanJO
簖	duanK
籪	duanKM
褍	duanKN
端	duanL
腶	duanLM
媏	duanNM
段	duanP
碫	duanPM
毈	duanPN
短	duanS
塅	duanTM
葮	duanUM
偳	duanVM
瑖	duanWM
躖	duanZM
赌	duB
賭	duBM
凟	duBN
贕	duBO
蠹	duC
蝳	duCM
螙	duCN
蠧	duCO
剢	duDM
殬	duDN
殰	duDO
渡	duE
渎	duEB
瀆	duEM
涜	duEN
都	duF
匵	duFM
度	duG
髑	duGB
靯	duGM
豄	duGN
韇	duGO
黩	duH
黷	duHM
秺	duHN
杜	duI
搥	duiAM
兑	duiB
椟	duIBL
兌	duiBM
痽	duiBN
对	duiC
對	duiCM
対	duiCN
轛	duiCO
兊	duiEM
濧	duiEN
濻	duiEO
瀢	duiEP
瀩	duiEQ
队	duiF
隊	duiFM
陮	duiFN
綐	duiFO
杸	duiIM
镦	duiJ
鐓	duiJM
錞	duiJN
鐜	duiJO
櫝	duIM
鴭	duiNM
啍	duiOM
碓	duiP
磓	duiPM
祋	duiSM
堆	duiT
垖	duiTM
塠	duiTN
薱	duiUM
敦	duiW
敓	duiWM
敚	duiWN
怼	duiX
憝	duiXB
懟	duiXM
憞	duiXN
頧	duiYM
譈	duiYN
譵	duiYO
镀	duJ
鍍	duJM
帾	duJN
覩	duJO
錖	duJP
鑟	duJQ
笃	duK
篤	duKM
裻	duKN
肚	duL
毒	duM
督	duMB
睹	duMC
阇	duMM
闍	duMN
騳	duMO
妒	duN
撴	dunAM
撉	dunAN
犊	duNB
蜳	dunCM
沌	dunE
潡	dunEM
庉	dunGM
炖	dunH
不	dunHB
燉	dunHM
楯	dunIM
橔	dunIN
钝	dunJ
镦	dunJB
鈍	dunJM
鐓	dunJN
盾	dunM
盹	dunMB
犢	duNML
驐	dunMM
妬	duNN
犜	dunNM
吨	dunO
姤	duNOL
噸	dunOM
礅	dunP
砘	dunPB
嬻	duNPL
碷	dunPM
獤	dunQM
壿	dunSM
墩	dunT
坉	dunTM
墫	dunTN
墪	dunTO
伅	dunVM
敦	dunW
囤	dunWB
忳	dunXM
惇	dunXN
憞	dunXO
顿	dunY
頓	dunYM
蹲	dunZ
遁	dunZB
趸	dunZC
躉	dunZM
逇	dunZN
遯	dunZO
踲	dunZP
蹾	dunZQ
嘟	duO
掇	duoA
挆	duoAM
挅	duoAN
痑	duoBM
痥	duoBN
凙	duoBO
鬌	duoBP
夺	duoD
剁	duoDB
奪	duoDM
刴	duoDN
剟	duoDO
剫	duoDP
奲	duoDQ
沲	duoE
澤	duoEM
沰	duoEN
缍	duoF
綞	duoFM
陏	duoFN
陊	duoFO
隓	duoFP
度	duoG
朵	duoI
柁	duoIB
朶	duoIM
杕	duoIN
杝	duoIO
枤	duoIP
柂	duoIQ
柮	duoIR
桗	duoIS
椯	duoIT
铎	duoJ
鐸	duoJM
鈬	duoJN
錞	duoJO
裰	duoK
袳	duoKM
驮	duoM
叾	duOML
馱	duoMM
毲	duoMN
駄	duoMO
媠	duoNM
鵽	duoNN
哆	duoO
咄	duoOB
哚	duoOC
喥	duoOM
嚉	duoON
嚲	duoOO
硾	duoPM
躲	duoS
饳	duoSM
崜	duoSN
躱	duoSO
飿	duoSP
嶞	duoSQ
軃	duoSR
堕	duoT
垛	duoTB
墮	duoTM
垜	duoTN
埵	duoTO
墯	duoTP
亸	duoTQ
仛	duoVM
敓	duoWM
敚	duoWN
敠	duoWO
敪	duoWP
多	duoX
惰	duoXB
夛	duoXM
憜	duoXN
尮	duoYM
鮵	duoYN
跺	duoZ
舵	duoZB
踱	duoZC
趓	duoZM
跢	duoZN
跥	duoZO
牍	duP
牘	duPM
皾	duPN
独	duQ
獨	duQM
醏	duQN
暏	duRM
晵	duRN
厾	duSM
堵	duT
芏	duU
荰	duUM
琽	duWM
斁	duWN
瓄	duWO
韣	duWP
韥	duWQ
读	duY
顿	duYB
讀	duYM
頓	duYN
読	duYP
讟	duYQ
扼	eA
搕	eAM
搹	eAN
搤	eAO
擜	eAP
匎	eBM
皒	eBN
痾	eBO
痷	eBP
齃	eBQ
厄	eC
蛾	eCB
轭	eCC
軛	eCM
蚅	eCN
軶	eCO
蝁	eCP
齶	eCQ
洝	eEM
涐	eEN
湂	eEO
阿	eF
鄂	eFB
阨	eFM
阸	eFN
廅	eGM
戹	eHM
枙	eIM
櫮	eIN
欸	eiQM
诶	eiY
誒	eiYM
锷	eJ
锇	eJB
鋨	eJM
鍔	eJN
卾	eJO
鈪	eJP
鈋	eJQ
覨	eJR
鑩	eJS
腭	eL
丨	eLB
閼	eMM
睋	eMN
騀	eMO
鹅	eN
摁	enA
娥	eNB
婀	eNC
鹗	eND
奀	enDM
鞥	engGM
煾	enHM
鵝	eNM
鶚	eNN
嗯	enO
唔	enOB
妸	eNOL
妿	eNP
姶	eNQ
娿	eNR
娾	eNS
峎	enSM
鵈	eNT
蒽	enU
鵞	eNUL
恩	enX
哦	eO
呃	eOB
噩	eOC
吪	eOM
呝	eON
咢	eOO
咹	eOP
噁	eOQ
屙	eP
砐	ePM
砈	ePN
砵	ePO
砨	ePP
硆	ePQ
磀	ePR
礘	ePS
欸	eQM
歞	eQN
贰	erB
貳	erBM
貮	erBN
髶	erBO
髵	erBP
輀	erCM
轜	erCN
刵	erDM
二	erE
儿	erEB
而	erEC
洱	erED
兒	erEM
児	erEN
耏	erEO
洏	erEP
耳	erF
陑	erFM
聏	erFN
隭	erFO
杒	erIM
栮	erIN
栭	erIO
梕	erIP
樲	erIQ
铒	erJ
鉺	erJM
袻	erKM
胹	erLM
臑	erLN
毦	erMM
粫	erMN
駬	erMO
鸸	erN
鴯	erNM
咡	erOM
唲	erON
饵	erS
餌	erSM
峏	erSN
荋	erUM
薾	erUN
佴	erV
侕	erVM
乻	erVN
珥	erW
尔	erX
爾	erXM
尓	erXN
尒	erXO
衈	erXP
鲕	erY
鮞	erYM
弍	erYN
弐	erYO
誀	erYP
迩	erZ
邇	erZM
趰	erZN
饿	eS
峨	eSB
餓	eSM
岋	eSN
峉	eSO
峩	eSP
豟	eSQ
崿	eSR
餩	eSS
垩	eT
堊	eTM
堨	eTN
堮	eTO
萼	eU
莪	eUB
苊	eUC
蕚	eUM
俄	eV
偔	eVM
僫	eVN
囮	eWM
敋	eWN
珴	eWO
琧	eWP
恶	eX
愕	eXB
惡	eXM
悪	eXN
额	eY
鳄	eYB
诶	eYC
颚	eYD
讹	eYE
谔	eYF
訛	eYM
額	eYN
諤	eYO
顎	eYP
鱷	eYQ
頋	eYR
誐	eYS
魤	eYT
頟	eYU
頞	eYV
譌	eYW
鰐	eYX
鰪	eYY
讍	eYZ
遏	eZ
迗	eZM
遌	eZN
遻	eZO
發	faBM
冹	faBN
疺	faBO
発	faBP
髪	faBQ
髮	faBR
法	faE
沷	faEM
浌	faEN
灋	faEO
彂	faGM
栰	faIM
橃	faIN
鍅	faJM
筏	faK
笩	faKM
阀	faM
閥	faMM
瞂	faMN
払	fanAM
贩	fanB
販	fanBM
軓	fanCM
軬	fanCN
輽	fanCO
轓	fanCP
蠜	fanCQ
樊	fanD
泛	fanE
氾	fanEM
汎	fanEN
滼	fanEO
瀪	fanEP
瀿	fanEQ
繁	fanF
匥	fanFM
緐	fanFN
旙	fanFO
旛	fanFP
繙	fanFQ
颿	fanFR
飜	fanFS
髣	fangBM
彷	fangC
蚄	fangCM
汸	fangEM
淓	fangEN
方	fangF
防	fangFB
纺	fangFC
邡	fangFD
匚	fangFE
紡	fangFM
旊	fangFN
房	fangH
枋	fangI
钫	fangJ
鈁	fangJM
錺	fangJN
肪	fangL
眆	fangMM
眪	fangMN
妨	fangN
牥	fangNM
鴋	fangNN
鶭	fangNO
昉	fangRM
昘	fangRN
昞	fangRO
祊	fangSM
坊	fangT
埅	fangTM
堏	fangTN
芳	fangU
仿	fangV
倣	fangVM
放	fangW
瓬	fangWM
访	fangY
鲂	fangYB
訪	fangYM
魴	fangYN
舫	fangZ
趽	fangZM
烦	fanH
燔	fanHB
煩	fanHM
梵	fanI
杋	fanIM
柉	fanIN
桳	fanIO
棥	fanIP
橎	fanIQ
凡	fanJ
帆	fanJB
幡	fanJC
钒	fanJD
釩	fanJM
凣	fanJN
凢	fanJO
鐇	fanJP
範	fanKM
笵	fanKN
笲	fanKO
襎	fanKP
籓	fanKQ
勫	fanLM
膰	fanLN
姂	faNM
籵	fanMM
盕	fanMN
奿	fanNM
婏	fanNN
嬏	fanNO
嬎	fanNP
鷭	fanNQ
噃	fanOM
矾	fanP
礬	fanPM
犯	fanQ
犭	fanQB
犿	fanQM
饭	fanS
飯	fanSM
飰	fanSN
番	fanT
畈	fanTB
畨	fanTM
墦	fanTN
范	fanU
藩	fanUB
蕃	fanUC
蘩	fanUD
薠	fanUM
仮	fanVM
攵	fanW
璠	fanWM
忛	fanXM
憣	fanXN
反	fanY
翻	fanYB
訉	fanYM
羳	fanYN
鱕	fanYO
返	fanZ
夂	fanZB
蹯	fanZC
辺	fanZM
舤	fanZN
舧	fanZO
舩	fanZP
乏	faP
砝	faPB
酦	faQM
醗	faQN
醱	faQO
罚	faS
罰	faSM
峜	faSN
罸	faSO
垡	faT
坺	faTM
墢	faTN
茷	faUM
蕟	faUN
藅	faUO
伐	faV
佱	faVM
傠	faVN
珐	faW
琺	faWM
发	faY
费	feiB
痱	feiBB
費	feiBM
發	feiBN
疿	feiBO
癈	feiBP
蜚	feiC
厞	feiCM
蜰	feiCN
蟦	feiCO
剕	feiDM
奜	feiDN
沸	feiE
淝	feiEB
渄	feiEM
濷	feiEN
飞	feiF
非	feiFB
匪	feiFC
绯	feiFD
飛	feiFM
緋	feiFN
陫	feiFO
靟	feiFP
飝	feiFQ
废	feiG
廢	feiGM
廃	feiGN
扉	feiH
榧	feiI
杮	feiIM
柹	feiIN
棐	feiIO
橨	feiIP
橃	feiIQ
櫠	feiIR
镄	feiJ
鐨	feiJM
篚	feiK
笰	feiKM
裶	feiKN
襏	feiKO
肥	feiL
肺	feiLB
腓	feiLC
胏	feiLM
胇	feiLN
朏	feiLO
胐	feiLP
騑	feiMM
騛	feiMN
妃	feiN
婓	feiNM
婔	feiNN
啡	feiO
吠	feiOB
砩	feiP
屝	feiPM
狒	feiQ
犻	feiQM
猆	feiQN
霏	feiR
昲	feiRM
暃	feiRN
曊	feiRO
靅	feiRP
餥	feiSM
鼣	feiSN
菲	feiU
芾	feiUB
萉	feiUM
蕜	feiUN
俷	feiVM
斐	feiW
悱	feiX
怫	feiXB
馡	feiXM
翡	feiY
诽	feiYB
鲱	feiYC
誹	feiYM
鯡	feiYN
蚡	fenCM
蚠	fenCN
轒	fenCO
分	fenD
奋	fenDB
奮	fenDM
汾	fenE
瀵	fenEB
濆	fenEM
纷	fenF
紛	fenFM
隫	fenFN
捀	fengAM
摓	fengAN
疯	fengB
冯	fengBB
瘋	fengBM
赗	fengBN
賵	fengBO
寷	fengBP
封	fengC
蜂	fengCB
蠭	fengCM
奉	fengD
豐	fengDM
沣	fengE
灃	fengEM
沨	fengEN
浲	fengEO
湗	fengEP
溄	fengEQ
渢	fengER
漨	fengES
风	fengF
缝	fengFB
酆	fengFC
風	fengFM
縫	fengFN
綘	fengFO
鄷	fengFP
飌	fengFQ
烽	fengH
炐	fengHM
焨	fengHN
煈	fengHO
熢	fengHP
枫	fengI
楓	fengIM
桻	fengIN
檒	fengIO
锋	fengJ
凤	fengJB
鋒	fengJM
凨	fengJN
凬	fengJO
凮	fengJP
鎽	fengJQ
鏠	fengJR
篈	fengKM
丰	fengL
弅	fenGM
馮	fengMM
盽	fengMN
麷	fengMO
鼖	fenGN
鳳	fengNM
妦	fengNN
犎	fengNO
鳯	fengNP
鴌	fengNQ
唪	fengO
砜	fengP
碸	fengPM
猦	fengQM
靊	fengRM
峰	fengS
峯	fengSM
崶	fengSN
埄	fengTM
堼	fengTN
堸	fengTO
葑	fengU
莑	fengUM
蘴	fengUN
俸	fengV
仹	fengVM
偑	fengVN
僼	fengVO
琒	fengWM
覂	fengXM
讽	fengY
諷	fengYM
甮	fengYN
逢	fengZ
夆	fengZM
艂	fengZN
焚	fenH
炃	fenHM
秎	fenHN
燓	fenHO
燌	fenHP
棼	fenI
枌	fenIM
棻	fenIN
梤	fenIO
橨	fenIP
帉	fenJM
鈖	fenJN
幩	fenJO
鐼	fenJP
衯	fenKM
朌	fenLM
竕	fenLN
膹	fenLO
粉	fenM
粪	fenMB
糞	fenMM
瞓	fenMN
黂	fenMO
妢	fenNM
鳻	fenNN
吩	fenO
哛	fenOM
砏	fenPM
氛	fenQ
酚	fenQB
獖	fenQM
昐	fenRM
雰	fenRN
朆	fenRO
鼢	fenS
岎	fenSM
躮	fenSN
豮	fenSO
餴	fenSP
豶	fenSQ
饙	fenSR
坟	fenT
墳	fenTM
坆	fenTN
坋	fenTO
芬	fenU
蒶	fenUM
蕡	fenUN
份	fenV
偾	fenVB
僨	fenVM
玢	fenW
瓰	fenWM
愤	fenX
忿	fenXB
憤	fenXM
馚	fenXN
馩	fenXO
鲼	fenY
鱝	fenYM
羒	fenYN
翂	fenYO
訜	fenYP
魵	fenYQ
黺	fenYR
羵	fenYS
覅	fiaoXM
梻	foIM
坲	foTM
殕	fouDM
缶	fouF
缻	fouFM
缹	fouFN
紑	fouFO
炰	fouHM
妚	fouNM
鴀	fouNN
否	fouO
雬	fouRM
佛	foV
仏	foVM
仸	foVN
扶	fuA
抚	fuAB
拂	fuAC
拊	fuAD
撫	fuAM
払	fuAN
抙	fuAO
捊	fuAP
捬	fuAQ
富	fuB
负	fuBB
赋	fuBC
匐	fuBD
赙	fuBE
負	fuBM
賦	fuBN
賻	fuBO
冹	fuBP
髴	fuBQ
癁	fuBR
辅	fuC
蝠	fuCB
辐	fuCC
蝮	fuCD
蚨	fuCE
蜉	fuCF
復	fuCM
輔	fuCN
輻	fuCO
彿	fuCP
尃	fuCQ
蚥	fuCR
蚹	fuCS
蛗	fuCT
蜅	fuCU
蝜	fuCV
輹	fuCW
夫	fuD
副	fuDB
刜	fuDM
浮	fuE
涪	fuEB
滏	fuEC
泭	fuEM
洑	fuEN
澓	fuEO
父	fuF
附	fuFB
缚	fuFC
釜	fuFD
阜	fuFE
绂	fuFF
绋	fuFG
阝	fuFH
郛	fuFI
縛	fuFM
紱	fuFN
紼	fuFO
邞	fuFP
郙	fuFQ
旉	fuFR
紨	fuFS
絥	fuFT
颫	fuFU
鄜	fuFV
綍	fuFW
綒	fuFX
颰	fuFY
緮	fuFZ
纀	fuFZL
府	fuG
弗	fuGB
弣	fuGM
鬴	fuGN
稃	fuH
炥	fuHM
虙	fuHN
烰	fuHO
秿	fuHP
焤	fuHQ
稪	fuHR
桴	fuI
枎	fuIM
柭	fuIN
柎	fuIO
枹	fuIP
柫	fuIQ
栿	fuIR
棴	fuIS
椨	fuIT
椱	fuIU
榑	fuIV
幅	fuJ
斧	fuJB
凫	fuJC
幞	fuJD
巿	fuJM
帗	fuJN
釡	fuJO
鈇	fuJP
鉜	fuJQ
鉘	fuJR
鍢	fuJS
鍑	fuJT
符	fuK
袱	fuKB
襆	fuKM
衭	fuKN
袚	fuKO
袝	fuKP
笰	fuKQ
筟	fuKR
箙	fuKS
箁	fuKT
褔	fuKU
複	fuKV
簠	fuKW
襥	fuKX
服	fuL
腹	fuLB
肤	fuLC
脯	fuLD
腑	fuLE
膚	fuLM
竎	fuLN
胕	fuLO
驸	fuM
麸	fuMB
駙	fuMM
麩	fuMN
冨	fuMO
盙	fuMP
粰	fuMQ
麬	fuMR
糐	fuMS
麱	fuMT
妇	fuN
婦	fuNM
鳧	fuNN
乀	fuNO
妋	fuNP
姇	fuNQ
鳬	fuNR
娐	fuNS
婏	fuNT
媍	fuNU
鳺	fuNV
鴔	fuNW
嬔	fuNX
鵩	fuNY
鶝	fuNZ
咐	fuO
呒	fuOB
呋	fuOC
嘸	fuOM
咈	fuON
哹	fuOO
喸	fuOP
砩	fuP
砆	fuPM
氟	fuQ
酜	fuQM
腐	fuR
福	fuS
罘	fuSB
祓	fuSC
艴	fuSD
岪	fuSM
峊	fuSN
祔	fuSO
罦	fuSP
豧	fuSQ
禣	fuSR
甶	fuTM
坿	fuTN
垘	fuTO
畐	fuTP
畉	fuTQ
垺	fuTR
畗	fuTS
芙	fuU
莆	fuUB
茯	fuUC
苻	fuUD
菔	fuUE
芾	fuUF
莩	fuUG
芣	fuUM
茀	fuUN
荂	fuUO
荴	fuUP
萉	fuUQ
葍	fuUR
萯	fuUS
蓲	fuUT
蕧	fuUU
付	fuV
伏	fuVB
傅	fuVC
佛	fuVD
俘	fuVE
俯	fuVF
乥	fuVM
伕	fuVN
乶	fuVO
俌	fuVP
俛	fuVQ
偪	fuVR
偩	fuVS
敷	fuW
玞	fuWM
玸	fuWN
韨	fuWO
琈	fuWP
韍	fuWQ
璷	fuWR
覆	fuX
馥	fuXB
怫	fuXC
怤	fuXM
覄	fuXN
懯	fuXO
甫	fuY
讣	fuYB
黻	fuYC
鲋	fuYD
黼	fuYE
鳆	fuYF
訃	fuYM
鮒	fuYN
鰒	fuYO
翇	fuYP
詂	fuYQ
頫	fuYR
鮄	fuYS
諨	fuYT
鮲	fuYU
复	fuZ
赴	fuZB
孵	fuZC
孚	fuZD
趺	fuZE
跗	fuZF
艀	fuZM
踾	fuZN
轧	gaC
軋	gaCM
夹	gaD
夾	gaDM
魀	gaGM
摡	gaiAM
赅	gaiB
賅	gaiBM
匃	gaiBN
匄	gaiBO
賌	gaiBP
溉	gaiE
漑	gaiEM
陔	gaiF
郂	gaiFM
隑	gaiFN
絠	gaiFO
絯	gaiFP
戤	gaiG
丐	gaiH
概	gaiI
杚	gaiIM
槩	gaiIN
槪	gaiIO
钙	gaiJ
鈣	gaiJM
盖	gaiM
姟	gaiNM
硙	gaiPM
磑	gaiPN
晐	gaiRM
峐	gaiSM
祴	gaiSN
豥	gaiSO
垓	gaiT
畡	gaiTM
芥	gaiU
蓋	gaiUM
荄	gaiUN
葢	gaiUO
乢	gaiVM
侅	gaiVN
改	gaiW
瓂	gaiWM
忋	gaiXM
该	gaiY
該	gaiYM
钆	gaJ
釓	gaJM
錷	gaJN
朒	gaLM
擀	ganA
赣	ganB
疳	ganBB
贛	ganBM
凎	ganBN
贑	ganBO
泔	ganE
淦	ganEB
澉	ganEC
汵	ganEM
漧	ganEN
澸	ganEO
灨	ganEP
绀	ganF
紺	ganFM
干	ganG
扛	gangA
掆	gangAM
摃	gangAN
甘	ganGB
冮	gangBM
疘	gangBN
刚	gangD
剛	gangDM
港	gangE
纲	gangF
缸	gangFB
綱	gangFM
罁	gangFN
焵	gangHM
焹	gangHN
杠	gangI
棡	gangIM
槓	gangIN
钢	gangJ
鋼	gangJM
釭	gangJN
鎠	gangJO
筻	gangK
肛	gangL
幹	ganGM
骭	ganGN
牨	gangNM
犅	gangNN
魐	ganGO
矼	gangPM
碙	gangPN
犺	gangQM
岗	gangS
罡	gangSB
岡	gangSM
崗	gangSN
冈	gangT
堈	gangTM
堽	gangTN
戆	gangX
戇	gangXM
戅	gangXN
秆	ganH
稈	ganHM
杆	ganI
橄	ganIB
柑	ganIC
桿	ganIM
榦	ganIN
檊	ganIO
凲	ganJM
竿	ganK
衦	ganKM
笴	ganKN
筸	ganKO
篢	ganKP
簳	ganKQ
肝	ganL
盰	ganMM
粓	ganMN
姏	ganNM
鳱	ganNN
咁	ganOM
矸	ganP
皯	ganPM
酐	ganQ
旰	ganR
坩	ganT
苷	ganU
芉	ganUM
乾	ganV
仠	ganVM
佄	ganVN
乹	ganVO
倝	ganVP
亁	ganVQ
敢	ganW
玕	ganWM
攼	ganWN
玵	ganWO
尶	ganWP
感	ganX
忓	ganXM
尴	ganY
尷	ganYM
詌	ganYN
尲	ganYO
鳡	ganYP
鱤	ganYQ
赶	ganZ
趕	ganZM
迀	ganZN
嘎	gaO
搞	gaoA
咖	gaOB
皋	gaoBL
皐	gaoBM
噶	gaOC
夰	gaoDM
郜	gaoF
缟	gaoFB
縞	gaoFM
高	gaoG
髙	gaoGM
鼛	gaoGN
稿	gaoH
稁	gaoHM
稾	gaoHN
槁	gaoI
杲	gaoIB
槔	gaoIC
橰	gaoIM
槀	gaoIN
槹	gaoIO
檺	gaoIP
櫜	gaoIQ
镐	gaoJ
锆	gaoJB
鎬	gaoJM
鋯	gaoJN
篙	gaoK
筶	gaoKM
膏	gaoL
勂	gaoLM
糕	gaoM
嘠	gaOML
睪	gaoMM
鷎	gaoNM
鷱	gaoNN
告	gaoO
吿	gaoOM
睾	gaoP
獋	gaoQM
暠	gaoRM
峼	gaoSM
祮	gaoSN
祰	gaoSO
禞	gaoSP
餻	gaoSQ
藁	gaoU
菒	gaoUM
藳	gaoUN
韟	gaoWM
羔	gaoY
诰	gaoYB
誥	gaoYM
羙	gaoYN
臯	gaoZM
玍	gaPM
旮	gaR
垓	gaT
伽	gaV
尜	gaX
尕	gaXB
尬	gaY
搁	geA
搿	geAB
擱	geAM
扢	geAN
挌	geAO
疙	geB
匌	geBM
蛤	geC
虼	geCB
蛒	geCM
輵	geCN
轕	geCO
割	geD
滒	geEM
滆	geEN
隔	geF
纥	geFB
紇	geFM
革	geG
戈	geGB
骼	geGC
鬲	geGD
戓	geGM
彁	geGN
戨	geGO
鞈	geGP
鞷	geGQ
格	geI
给	geiF
給	geiFM
杚	geIM
槅	geIN
櫊	geIO
铬	geJ
镉	geJB
鉻	geJM
鎘	geJN
觡	geJO
鎑	geJP
鎶	geJQ
袼	geK
笴	geKM
裓	geKN
箇	geKO
胳	geL
膈	geLB
肐	geLM
臈	geLN
阁	geM
盖	geMB
閣	geMM
閤	geMN
騔	geMO
鸽	geN
搄	genAM
揯	genAN
亙	genEM
艮	genG
挭	gengAM
賡	gengBM
刯	gengDM
亙	gengEM
浭	gengEN
耿	gengF
绠	gengFB
綆	gengFM
郠	gengFN
絙	gengFO
絚	gengFP
縆	gengFQ
緪	gengFR
庚	gengG
赓	gengGB
骾	gengGM
更	gengH
焿	gengHM
梗	gengI
椩	gengIM
耕	gengL
鹒	gengNM
鶊	gengNN
哽	gengO
暅	gengRM
峺	gengSM
埂	gengT
畊	gengTM
堩	gengTN
莄	gengUM
菮	gengUN
羹	gengY
颈	gengYB
鲠	gengYC
羮	gengYM
鯁	gengYN
頸	gengYO
亘	genH
根	genI
鴿	geNM
牫	geNN
哏	genO
鴚	geNOL
鴐	geNP
茛	genU
跟	genZ
哥	geO
合	geOB
各	geOC
咯	geOD
嗝	geOE
哿	geOF
吤	geOM
呄	geON
嘅	geOO
嗰	geOP
硌	geP
歌	geQ
犵	geQM
猲	geQN
獦	geQO
饹	geSM
餎	geSN
圪	geT
塥	geTB
葛	geU
蓋	geUM
茖	geUN
虄	geUO
个	geV
仡	geVB
個	geVM
佮	geVN
佫	geVO
敋	geWM
韐	geWN
韚	geWO
愅	geXM
颌	geY
頜	geYM
鲄	geYN
魺	geYO
諽	geYP
鮯	geYQ
鮥	geYR
謌	geYS
舸	geZ
臵	geZM
怾	giXM
拱	gongA
拲	gongAM
公	gongB
宫	gongBB
共	gongBC
贡	gongBD
貢	gongBM
宮	gongBN
贛	gongBO
匑	gongBP
匔	gongBQ
髸	gongBR
蚣	gongC
輁	gongCM
汞	gongE
澒	gongEM
红	gongF
紅	gongFM
糼	gongFN
糿	gongFO
工	gongG
弓	gongGB
巩	gongGC
廾	gongGD
鞏	gongGM
熕	gongHM
杛	gongIM
栱	gongIN
觥	gongJ
幊	gongJM
銾	gongJN
觵	gongJO
兝	gongKM
兣	gongKN
篢	gongKO
功	gongL
龚	gongLB
肱	gongLC
龔	gongLM
龏	gongLN
唝	gongOM
嗊	gongON
碽	gongPM
躬	gongS
厷	gongSM
躳	gongSN
塨	gongTM
供	gongV
侊	gongVM
攻	gongW
珙	gongWB
恭	gongX
愩	gongXM
慐	gongXN
羾	gongYM
搆	gouAM
撀	gouAN
购	gouB
勾	gouBB
購	gouBM
痀	gouBN
蚼	gouCM
沟	gouE
溝	gouEM
缑	gouF
緱	gouFM
鞲	gouG
煹	gouHM
构	gouI
枸	gouIB
構	gouIM
钩	gouJ
觏	gouJB
鉤	gouJM
覯	gouJN
鈎	gouJO
篝	gouK
笱	gouKB
袧	gouKM
褠	gouKN
簼	gouKO
耇	gouLM
耉	gouLN
耈	gouLO
糓	gouMM
媾	gouN
姤	gouNM
句	gouO
呴	gouOM
啂	gouON
彀	gouP
狗	gouQ
岣	gouS
垢	gouT
坸	gouTM
冓	gouTN
苟	gouU
芶	gouUM
佝	gouV
傋	gouVM
韝	gouWM
玽	gouWN
够	gouX
夠	gouXM
诟	gouY
詬	gouYM
訽	gouYN
遘	gouZ
豿	gouZM
雊	gouZN
挂	guaA
括	guaAB
掛	guaAM
寡	guaB
卦	guaBB
刮	guaD
剐	guaDB
剮	guaDM
劀	guaDN
颪	guaFM
絓	guaFN
緺	guaFO
颳	guaFP
瓜	guaG
煱	guaHM
栝	guaI
拐	guaiA
掴	guaiAB
摑	guaiAM
夬	guaiDM
枴	guaiIM
柺	guaiIN
箉	guaiKM
桰	guaIM
乖	guaiP
罫	guaiSM
怪	guaiX
恠	guaiXM
叏	guaiYM
铦	guaJM
銛	guaJN
銽	guaJO
褂	guaK
袿	guaKM
胍	guaL
扢	guAM
騧	guaMM
鸹	guaN
掼	guanA
摜	guanAM
关	guanB
官	guanBB
贯	guanBC
貫	guanBM
卝	guanBN
痯	guanBO
瘝	guanBP
癏	guanBQ
輨	guanCM
灌	guanE
涫	guanEB
泴	guanEM
淉	guanEN
潅	guanEO
罐	guanF
纶	guanFB
綸	guanFM
罆	guanFN
挄	guangAM
撗	guangAN
臦	guangCM
輄	guangCN
臩	guangCO
洸	guangEM
广	guangG
廣	guangGM
広	guangGN
灮	guangHM
炗	guangHN
炚	guangHO
炛	guangHP
烡	guangHQ
黆	guangHR
桄	guangI
欟	guangIM
銧	guangJM
胱	guangL
姯	guangNM
咣	guangO
硄	guangPM
犷	guangQ
獷	guangQM
垙	guangTM
茪	guangUM
侊	guangVM
俇	guangVN
僙	guangVO
珖	guangWM
光	guangX
逛	guangZ
爟	guanHM
棺	guanI
樌	guanIM
欟	guanIN
观	guanJ
觀	guanJM
覌	guanJN
錧	guanJO
観	guanJP
鏆	guanJQ
鑵	guanJR
管	guanK
筦	guanKM
抇	guANL
丱	guanLM
冠	guanM
矜	guanMB
盥	guanMC
鴰	guaNML
關	guanMM
毌	guanMN
矝	guanMO
閞	guanMP
関	guanMQ
闗	guanMR
矔	guanMS
鹳	guanN
鸛	guanNM
礶	guanPM
馆	guanS
館	guanSM
豘	guanSN
祼	guanSO
莞	guanU
蒄	guanUM
倌	guanV
舘	guanVM
琯	guanWM
璭	guanWN
瓘	guanWO
惯	guanX
慣	guanXM
悺	guanXN
悹	guanXO
窤	guanXP
鳏	guanY
鰥	guanYM
鳤	guanYN
鱞	guanYO
鱹	guanYP
遦	guanZM
雚	guanZN
躀	guanZO
呱	guaO
咼	guaOM
叧	guaON
啩	guaOO
歄	guaQM
罣	guaSM
罫	guaSN
冎	guaTM
坬	guaTN
苽	guaUM
诖	guaY
詿	guaYM
諣	guaYN
趏	guaZM
踻	guaZN
贾	guB
痼	guBB
賈	guBM
凅	guBN
蛊	guC
轱	guCB
蛄	guCC
蠱	guCM
軲	guCN
轂	guCO
蛌	guCP
軱	guCQ
沽	guE
汩	guEB
泒	guEM
淈	guEN
濲	guEO
瀔	guEP
縎	guFM
骨	guG
谷	guGB
鼓	guGC
鼔	guGM
稒	guHM
穀	guHN
梏	guI
摫	guiAM
撌	guiAN
贵	guiB
癸	guiBB
皈	guiBC
宄	guiBD
貴	guiBM
癐	guiBN
轨	guiC
軌	guiCM
軓	guiCN
蛫	guiCO
厬	guiCP
螝	guiCQ
蟡	guiCR
刽	guiD
刿	guiDB
劊	guiDM
劌	guiDN
氿	guiEM
湀	guiEN
溎	guiEO
潙	guiEP
匦	guiF
匭	guiFM
匱	guiFN
邽	guiFO
陒	guiFP
郌	guiFQ
鬼	guiG
龟	guiGB
庋	guiGC
龜	guiGM
庪	guiGN
亀	guiGO
廆	guiGP
鬶	guiGQ
鬹	guiGR
鞼	guiGS
炅	guiH
柜	guiI
桂	guiIB
桧	guiIC
櫃	guiIM
檜	guiIN
朹	guiIO
椝	guiIP
椢	guiIQ
槼	guiIR
槻	guiIS
槶	guiIT
槣	guiIU
樻	guiIV
櫰	guiIW
櫷	guiIX
规	guiJ
規	guiJM
帰	guiJN
觤	guiJO
鐀	guiJP
鑎	guiJQ
簋	guiK
袿	guiKM
筀	guiKN
簂	guiKO
襘	guiKP
胿	guiLM
闺	guiM
杚	guIML
閨	guiMM
瞆	guiMN
瞡	guiMO
瞶	guiMP
騩	guiMQ
妫	guiN
柧	guINL
媯	guiNM
姽	guiNN
嫢	guiNO
鳺	guiNP
嬀	guiNQ
棝	guIO
硅	guiP
榾	guIPL
硊	guiPM
榖	guIQ
猤	guiQM
晷	guiR
橭	guIRL
昋	guiRM
櫎	guIS
祪	guiSM
嶡	guiSN
嶲	guiSO
禬	guiSP
巂	guiSQ
圭	guiT
垝	guiTM
茥	guiUM
蓕	guiUN
蘬	guiUO
佹	guiVM
瑰	guiW
珪	guiWM
璝	guiWN
瓌	guiWO
归	guiX
恑	guiXM
窐	guiXN
诡	guiY
鲑	guiYB
鳜	guiYC
詭	guiYM
鮭	guiYN
鱖	guiYO
鱥	guiYP
跪	guiZ
歸	guiZM
攰	guiZN
攱	guiZO
趹	guiZP
雟	guiZQ
锢	guJ
钴	guJB
觚	guJC
錮	guJM
鈷	guJN
鈲	guJO
箍	guK
笟	guKM
箛	guKN
篐	guKO
股	guL
臌	guLB
脵	guLM
瞽	guM
糓	guMM
盬	guMN
姑	guN
鸪	guNB
鹄	guNC
辊	gunCL
輥	gunCM
鹘	guND
滚	gunE
牯	guNEL
滾	gunEM
绲	gunF
牿	guNFL
緄	gunFM
緷	gunFN
棍	gunI
棞	gunIM
袞	gunKM
裷	gunKN
丨	gunL
鴣	guNM
睔	gunMM
鵠	guNN
鶻	guNO
磙	gunP
嫴	guNPL
硍	gunPM
衮	gunT
蓘	gunUM
蔉	gunUN
璭	gunWM
惃	gunXM
鲧	gunY
鯀	gunYM
鮌	gunYN
謴	gunYO
古	guO
掴	guoA
摑	guoAM
咕	guOB
瘑	guoBM
告	guOC
蜾	guoCB
蝈	guoCL
蟈	guoCM
輠	guoCN
呱	guOD
涡	guoE
嘏	guOEL
渦	guoEM
淉	guoEN
漍	guoEO
濄	guoEP
郭	guoF
聒	guoFB
聝	guoFM
綶	guoFN
彉	guoGM
彍	guoGN
虢	guoH
果	guoI
椁	guoIB
槨	guoIM
楇	guoIN
櫎	guoIO
锅	guoJ
帼	guoJB
鍋	guoJM
幗	guoJN
鈛	guoJO
鐹	guoJP
裹	guoK
褁	guoKM
簂	guoKN
腂	guoLM
腘	guoLN
膕	guoLO
唂	guOM
粿	guoMM
矌	guoMN
唃	guON
呙	guoO
啒	guOOL
咼	guoOM
咶	guoON
喐	guoOO
啯	guoOP
嘓	guoOQ
嗗	guOP
猓	guoQ
崞	guoS
馘	guoSB
馃	guoSM
餜	guoSN
埚	guoT
堝	guoTM
墎	guoTN
菓	guoUM
蔮	guoUN
国	guoW
囗	guoWB
國	guoWM
囯	guoWN
囶	guoWO
囻	guoWP
圀	guoWQ
敋	guoWR
惈	guoXM
慖	guoXN
懖	guoXO
过	guoZ
過	guoZM
毂	guP
硲	guPM
皷	guPN
磆	guPO
皼	guPP
酤	guQ
崮	guS
罟	guSB
峠	guSM
罛	guSN
崓	guSO
馉	guSP
祻	guSQ
餶	guSR
堌	guTM
菇	guU
菰	guUB
苽	guUM
蓇	guUN
薣	guUO
估	guV
傦	guVM
僱	guVN
故	guW
固	guWB
辜	guX
怘	guXM
愲	guXN
顾	guY
诂	guYB
鲴	guYC
顧	guYM
詁	guYN
鯝	guYO
羖	guYP
尳	guYQ
鮕	guYR
孤	guZ
雇	guZB
夃	guZM
逧	guZN
虾	haC
蛤	haCB
蝦	haCM
奤	haDM
紦	haFM
拸	haiAM
害	haiB
海	haiE
郂	haiFM
絯	haiFN
骸	haiG
烸	haiHM
胲	haiL
骇	haiM
駭	haiMM
駴	haiMN
妎	haiNM
嗨	haiO
咳	haiOB
嘿	haiOC
咍	haiOM
嗐	haiON
嚡	haiOO
氦	haiQ
醢	haiQB
猲	haiQM
酼	haiQN
餀	haiSM
饚	haiSN
亥	haiT
塰	haiTM
侅	haiVM
还	haiZ
孩	haiZB
還	haiZM
铪	haJ
鉿	haJM
撼	hanA
捍	hanAB
撖	hanAC
扞	hanAM
寒	hanB
鼾	hanBB
兯	hanBM
皔	hanBN
蚶	hanC
厈	hanCM
虷	hanCN
蛿	hanCO
蜭	hanCP
蜬	hanCQ
輚	hanCR
螒	hanCS
鬫	hanDM
汉	hanE
汗	hanEB
涵	hanEC
瀚	hanED
漢	hanEM
汵	hanEN
涆	hanEO
浛	hanEP
浫	hanEQ
澏	hanER
邯	hanF
邗	hanFB
貥	hangBM
行	hangC
蚢	hangCM
夯	hangD
沆	hangE
绗	hangF
絎	hangFM
邟	hangFN
斻	hangFO
骯	hangGM
杭	hangI
笐	hangKM
裄	hangKN
筕	hangKO
甝	hanGM
谽	hanGN
妔	hangNM
吭	hangO
豃	hanGOL
巷	hangS
垳	hangTM
苀	hangUM
忼	hangXM
颃	hangY
頏	hangYM
魧	hangYN
航	hangZ
迒	hangZM
焊	hanH
焓	hanHB
熯	hanHM
梒	hanIM
椷	hanIN
榦	hanIO
釬	hanJM
銲	hanJN
鋡	hanJO
鋎	hanJP
函	hanK
凾	hanKM
笒	hanKN
筨	hanKO
肣	hanLM
罕	hanM
阚	hanMB
闞	hanMM
闬	hanMN
閈	hanMO
睅	hanMP
馯	hanMQ
駻	hanMR
娢	hanNM
鳱	hanNN
嫨	hanNO
鶾	hanNP
含	hanO
喊	hanOB
哻	hanOM
唅	hanON
酣	hanQ
犴	hanQB
猂	hanQM
歛	hanQN
旱	hanR
晗	hanRB
晘	hanRM
晥	hanRN
暵	hanRO
屽	hanSM
崡	hanSN
嵅	hanSO
垾	hanTM
菡	hanU
莟	hanUM
蔊	hanUN
仠	hanVM
佄	hanVN
傼	hanVO
韩	hanW
韓	hanWM
攼	hanWN
圅	hanWO
琀	hanWP
悍	hanX
憾	hanXB
憨	hanXC
忓	hanXM
馠	hanXN
翰	hanY
颔	hanYB
顸	hanYC
頇	hanYM
頷	hanYN
魽	hanYO
顄	hanYP
譀	hanYQ
爳	hanZM
雗	hanZN
哈	haO
皓	haoB
皐	haoBM
皞	haoBN
皜	haoBO
皡	haoBP
皥	haoBQ
蚝	haoC
蠔	haoCM
浩	haoE
濠	haoEB
灏	haoEC
灝	haoEM
淏	haoEN
滜	haoEO
滈	haoEP
澔	haoEQ
郝	haoF
鄗	haoFM
聕	haoFN
號	haoHM
秏	haoHN
椃	haoIM
镐	haoJ
鎬	haoJM
兞	haoKM
籇	haoKN
耗	haoL
竓	haoLM
毫	haoM
好	haoN
号	haoO
嚎	haoOB
嗥	haoOC
嚆	haoOD
呺	haoOM
哠	haoON
噑	haoOO
嘷	haoOP
獆	haoQM
獔	haoQN
獋	haoQO
昊	haoR
昦	haoRM
晧	haoRN
暤	haoRO
暠	haoRP
暭	haoRQ
曍	haoRR
豪	haoS
壕	haoT
蒿	haoU
薅	haoUB
茠	haoUM
薧	haoUN
薃	haoUO
藃	haoUP
乚	haoVM
侴	haoVN
傐	haoVO
儫	haoVP
悎	haoXM
恏	haoXN
颢	haoY
顥	haoYM
諕	haoYN
鰝	haoYO
譹	haoYP
貉	haoZ
臯	haoZM
乤	haVM
抲	heAM
挌	heAN
贺	heB
賀	heBM
寉	heBN
癋	heBO
皬	heBP
齃	heBQ
赫	heC
蚵	heCB
龁	heCM
螛	heCN
齕	heCO
蠚	heCP
河	heE
涸	heEB
渮	heEM
澕	heEN
纥	heF
紇	heFM
郃	heFN
鞨	heGM
和	heH
禾	heHB
焃	heHM
煂	heHN
熆	heHO
熇	heHP
爀	heHQ
燺	heHR
核	heI
潶	heiEM
黑	heiH
黒	heiHM
柇	heIM
楁	heIN
嘿	heiO
嗨	heiOB
釛	heJM
鉌	heJN
鑉	heJO
褐	heK
袔	heKM
篕	heKN
劾	heL
盒	heM
阖	heMB
阂	heMC
盍	heMD
閡	heMM
闔	heMN
盇	heMO
籺	heMP
盉	heMQ
粭	heMR
毼	heMS
麧	heMT
閤	heMU
鹤	heN
拫	henAM
痕	henB
很	henC
鵆	henCM
撗	hengAM
衡	hengC
鵆	hengCM
涥	hengEM
烆	hengHM
横	hengI
桁	hengIB
橫	hengIM
鑅	hengJM
胻	hengLM
脝	hengLN
鞎	henGM
姮	hengNM
鸻	hengNN
鴴	hengNO
哼	hengO
啈	hengOM
亨	hengT
蘅	hengU
佷	hengVM
珩	hengW
恒	hengX
恆	hengXM
悙	hengXN
鶴	heNM
鵠	heNN
姀	heNO
噷	henOM
鹖	heNP
狠	henQ
穒	heNQL
鶡	heNR
鶮	heNS
鸖	heNT
佷	henVM
恨	henX
詪	henYM
合	heO
呵	heOB
喝	heOC
吓	heOD
嗬	heOE
嚇	heOM
咼	heON
咊	heOO
哬	heOP
啝	heOQ
喛	heOR
嗃	heOS
噈	heOT
碋	hePM
礉	hePN
犵	heQM
狢	heQN
欱	heQO
猲	heQP
曷	heR
朅	heRM
靍	heRN
靎	heRO
靏	heRP
峆	heSM
饸	heSN
餄	heSO
餲	heSP
壑	heT
垎	heTM
荷	heU
菏	heUB
蓋	heUM
萂	heUN
何	heV
佫	heVM
敆	heWM
惒	heXM
覈	heXN
颌	heY
诃	heYB
翮	heYC
訶	heYM
頜	heYN
訸	heYO
鲄	heYP
詥	heYQ
魺	heYR
翯	heYS
謞	heYT
龢	heYU
貉	heZ
隺	heZM
貈	heZN
噷	hmOM
揈	hongAM
撔	hongAN
宏	hongB
訇	hongBB
宖	hongBM
轰	hongC
虹	hongCB
轟	hongCM
軣	hongCN
輷	hongCO
鬨	hongDM
洪	hongE
泓	hongEB
汯	hongEM
沗	hongEN
浲	hongEO
浤	hongEP
渱	hongEQ
溄	hongER
渹	hongES
潂	hongET
澒	hongEU
澋	hongEV
红	hongF
紅	hongFM
纮	hongFN
耾	hongFO
紘	hongFP
紭	hongFQ
綋	hongFR
弘	hongG
谹	hongGM
谼	hongGN
鞃	hongGO
谾	hongGP
彋	hongGQ
烘	hongH
黉	hongHB
黌	hongHM
灴	hongHN
焢	hongHO
鈜	hongJM
鉷	hongJN
銾	hongJO
鋐	hongJP
鍧	hongJQ
篊	hongKM
竑	hongLM
竤	hongLN
闳	hongM
閎	hongMM
粠	hongMN
閧	hongMO
闂	hongMP
闀	hongMQ
鸿	hongN
鴻	hongNM
妅	hongNN
娂	hongNO
哄	hongO
叿	hongOM
呍	hongON
吰	hongOO
吽	hongOP
唝	hongOQ
嗊	hongOR
嚝	hongOS
硔	hongPM
硡	hongPN
晎	hongRM
霐	hongRN
霟	hongRO
厷	hongSM
屸	hongSN
巆	hongSO
垬	hongTM
薨	hongU
荭	hongUB
蕻	hongUC
葒	hongUM
苰	hongUN
葓	hongUO
仜	hongVM
玒	hongWM
瓨	hongWN
玜	hongWO
愩	hongXM
慐	hongXN
讧	hongY
訌	hongYM
羾	hongYN
翃	hongYO
翝	hongYP
魟	hongYQ
瘊	houB
齁	houBM
厚	houC
後	houCB
洉	houEM
郈	houFM
鄇	houFN
骺	houG
帿	houJM
銗	houJN
鍭	houJO
篌	houK
腄	houLM
糇	houM
睺	houMM
后	houO
吼	houOB
喉	houOC
吽	houOM
呴	houON
猴	houQ
犼	houQM
矦	houSM
豞	houSN
餱	houSO
堠	houT
垕	houTM
茩	houUM
葔	houUN
候	houV
侯	houVB
鲎	houY
詬	houYM
鱟	houYN
鲘	houYO
翭	houYP
鮜	houYQ
翵	houYR
鯸	houYS
逅	houZ
护	huA
撶	huaAM
搳	huaAN
摦	huaAO
螖	huaCM
划	huaD
劃	huaDM
夻	huaDN
滑	huaE
澅	huaEM
繣	huaFM
黊	huaHM
桦	huaI
徊	huaiC
划	huaiD
劃	huaiDM
淮	huaiE
瀤	huaiEM
槐	huaiI
櫰	huaiIM
褢	huaiKM
褱	huaiKN
耲	huaiLM
樺	huaIM
杹	huaIN
枠	huaIO
咶	huaiOM
椛	huaIP
槬	huaIQ
坏	huaiT
壞	huaiTM
壊	huaiTN
蘾	huaiUM
蘹	huaiUN
佪	huaiVM
怀	huaiX
懷	huaiXM
懐	huaiXN
踝	huaiZ
铧	huaJ
鏵	huaJM
釪	huaJN
釫	huaJO
觟	huaJP
錵	huaJQ
鋘	huaJR
骅	huaM
抇	huAML
驊	huaMM
糀	huaMN
搰	huAN
换	huanA
擐	huanAB
換	huanAM
攌	huanAN
宦	huanB
寰	huanBB
鬟	huanBC
痪	huanBD
瘓	huanBM
寏	huanBN
轘	huanCM
奂	huanD
奐	huanDM
涣	huanE
浣	huanEB
洹	huanEC
漶	huanED
渙	huanEM
潅	huanEN
澣	huanEO
澴	huanEP
缓	huanF
缳	huanFB
郇	huanFC
緩	huanFM
繯	huanFN
絙	huanFO
綄	huanFP
酄	huanFQ
揘	huangAM
皇	huangB
癀	huangBB
宺	huangBM
皝	huangBN
皩	huangBO
蝗	huangC
徨	huangCB
蟥	huangCC
巟	huangCM
奛	huangDM
潢	huangE
湟	huangEB
汻	huangEM
滉	huangEN
兤	huangEO
隍	huangF
縨	huangFM
黄	huangH
煌	huangHB
黃	huangHM
炾	huangHN
熀	huangHO
熿	huangHP
穔	huangHQ
爌	huangHR
楻	huangIM
榥	huangIN
櫎	huangIO
凰	huangJ
幌	huangJB
锽	huangJM
鍠	huangJN
鎤	huangJO
鐄	huangJP
簧	huangK
篁	huangKB
肓	huangL
朚	huangLM
騜	huangMM
媓	huangNM
鷬	huangNN
喤	huangOM
磺	huangP
獚	huangQM
晃	huangR
晄	huangRM
曂	huangRN
崲	huangSM
餭	huangSN
塃	huangTM
堭	huangTN
墴	huangTO
荒	huangU
葟	huangUM
偟	huangVM
璜	huangW
瑝	huangWM
慌	huangX
恍	huangXB
惶	huangXC
怳	huangXM
衁	huangXN
愰	huangXO
谎	huangY
鳇	huangYB
謊	huangYM
鰉	huangYN
詤	huangYO
諻	huangYP
韹	huangYQ
鱑	huangYR
遑	huangZ
艎	huangZM
趪	huangZN
焕	huanH
煥	huanHM
烉	huanHN
桓	huanI
梙	huanIM
槵	huanIN
锾	huanJ
鍰	huanJM
镮	huanJN
鐶	huanJO
肒	huanLM
姡	huaNM
睆	huanMM
瞏	huanMN
瞣	huanMO
阛	huanMP
糫	huanMQ
闤	huanMR
驩	huanMS
婲	huaNN
鴅	huanNM
嬛	huanNN
鹮	huanNO
鵍	huanNP
孉	huanNQ
唤	huanO
婳	huaNOL
喚	huanOM
喛	huanON
嚾	huanOO
嬅	huaNP
欢	huanQ
獾	huanQB
嫿	huaNQL
歡	huanQM
犿	huanQN
狟	huanQO
獂	huanQP
歓	huanQQ
鷨	huaNR
豢	huanS
峘	huanSM
嵈	huanSN
豩	huanSO
豲	huanSP
堚	huanTM
萑	huanU
荁	huanUM
萈	huanUN
蒝	huanUO
藧	huanUP
环	huanW
圜	huanWB
環	huanWM
瑍	huanWN
瓛	huanWO
患	huanX
愌	huanXM
懁	huanXN
懽	huanXO
幻	huanY
鲩	huanYB
鯇	huanYM
羦	huanYN
鰀	huanYO
鯶	huanYP
讙	huanYQ
还	huanZ
逭	huanZB
還	huanZM
雈	huanZN
貆	huanZO
雚	huanZP
貛	huanZQ
哗	huaO
摢	huAOL
嘩	huaOM
呚	huaON
吪	huaOO
砉	huaP
硴	huaPM
磆	huaPN
猾	huaQ
华	huaS
崋	huaSM
舙	huaSN
画	huaT
畫	huaTM
埖	huaTN
畵	huaTO
花	huaU
華	huaUM
芲	huaUN
蕐	huaUO
蘤	huaUP
化	huaV
话	huaY
話	huaYM
鮭	huaYN
誮	huaYO
魤	huaYP
諣	huaYQ
諙	huaYR
譁	huaYS
譮	huaYT
冱	huB
冴	huBM
寣	huBN
鬍	huBO
蝴	huC
轷	huCB
軤	huCM
衚	huCN
螜	huCO
湖	huE
沪	huEB
浒	huEC
滹	huED
滬	huEM
滸	huEN
沍	huEO
汻	huEP
泘	huEQ
淲	huER
淴	huES
淈	huET
濩	huEU
瀫	huEV
匢	huFM
匫	huFN
絗	huFO
綔	huFP
鄠	huFQ
縎	huFR
縠	huFS
弧	huG
瓠	huGB
戏	huGC
戲	huGM
弖	huGN
瓡	huGO
戯	huGP
戱	huGQ
韄	huGR
虎	huH
互	huHB
户	huHC
和	huHD
扈	huHE
戽	huHF
煳	huHG
烀	huHH
虍	huHI
戶	huHM
戸	huHN
虖	huHO
焀	huHP
虝	huHQ
熩	huHR
槲	huI
挥	huiA
揮	huiAM
拻	huiAN
撝	huiAO
核	huIB
贿	huiBL
賄	huiBM
痐	huiBN
瘣	huiBO
寭	huiBP
辉	huiC
徽	huiCB
徊	huiCC
蛔	huiCD
虺	huiCE
蟪	huiCF
輝	huiCM
蟲	huiCN
蚘	huiCO
蛕	huiCP
蜖	huiCQ
輠	huiCR
螝	huiCS
徻	huiCT
殨	huiDM
汇	huiE
溃	huiEB
洄	huiEC
潰	huiEM
澮	huiEN
泋	huiEO
洃	huiEP
湏	huiEQ
滙	huiER
潓	huiES
濊	huiET
瀈	huiEU
绘	huiF
隳	huiFB
缋	huiFC
匯	huiFM
繪	huiFN
繢	huiFO
隓	huiFP
絵	huiFQ
戲	huiGM
廆	huiGN
戯	huiGO
灰	huiH
秽	huiHB
烩	huiHC
燴	huiHM
穢	huiHN
煒	huiHO
灳	huiHP
烠	huiHQ
烣	huiHR
煇	huiHS
燬	huiHT
桧	huiI
檜	huiIM
楎	huiIN
椲	huiIO
槥	huiIP
橞	huiIQ
檅	huiIR
檓	huiIS
櫘	huiIT
幑	huiJM
銊	huiJN
鏸	huiJO
鐬	huiJP
袆	huiKM
褘	huiKN
篲	huiKO
襘	huiKP
麾	huiM
枑	huIML
阓	huiMM
睳	huiMN
瞺	huiMO
闠	huiMP
靧	huiMQ
楛	huIN
婎	huiNM
媈	huiNN
嬒	huiNO
孈	huiNP
喙	huiO
咴	huiOB
楜	huIOL
噅	huiOM
噦	huiON
嘒	huiOO
噕	huiOP
嚖	huiOQ
毁	huiP
槴	huIPL
毀	huiPM
硊	huiPN
毇	huiPO
獩	huiQM
晖	huiR
晦	huiRB
會	huiRM
暉	huiRN
暳	huiRO
卉	huiS
屶	huiSM
屷	huiSN
叀	huiSO
豗	huiSP
禈	huiSQ
餯	huiSR
墮	huiTM
囘	huiTN
荟	huiU
茴	huiUB
蕙	huiUC
薈	huiUM
芔	huiUN
蔧	huiUO
薉	huiUP
藱	huiUQ
蘳	huiUR
会	huiV
佪	huiVM
僡	huiVN
儶	huiVO
回	huiW
珲	huiWB
琿	huiWM
囬	huiWN
圚	huiWO
璤	huiWP
璯	huiWQ
恢	huiX
慧	huiXB
悔	huiXC
惠	huiXD
彗	huiXE
恚	huiXF
恛	huiXM
恵	huiXN
彚	huiXO
彙	huiXP
憓	huiXQ
懳	huiXR
诲	huiY
讳	huiYB
诙	huiYC
誨	huiYM
諱	huiYN
詼	huiYO
廻	huiYP
廽	huiYQ
翙	huiYR
翚	huiYS
颒	huiYT
詯	huiYU
翬	huiYV
頮	huiYW
譭	huiYWL
鮰	huiYX
顪	huiYXL
翽	huiYY
鰴	huiYYL
譓	huiYZ
譿	huiYZL
迴	huiZM
逥	huiZN
斛	huJ
帍	huJM
幠	huJN
錿	huJO
鍸	huJP
鍙	huJQ
觷	huJR
笏	huK
箎	huKM
箶	huKN
簄	huKO
胡	huL
膴	huLM
糊	huM
粐	huMM
鹄	huN
掍	hunAM
鹘	huNB
鹕	huNC
轋	hunCM
鹱	huND
殙	hunDM
混	hunE
浑	hunEB
溷	hunEC
渾	hunEM
湣	hunEN
涽	hunEO
湷	hunEP
緄	hunFM
繉	hunFN
魂	hunG
焄	hunHM
焝	hunHN
棔	hunIM
觨	hunJM
阍	hunM
鵠	huNML
閽	hunMM
眃	hunMN
睧	hunMO
睴	hunMP
睯	hunMQ
婚	hunN
鶘	huNNL
婫	hunNM
鶻	huNO
鸌	huNP
姱	huNQ
昏	hunR
婟	huNRL
昬	hunRM
馄	hunS
媩	huNSL
餛	hunSM
餫	hunSN
鼲	hunSO
嫮	huNT
荤	hunU
嫭	huNUL
葷	hunUM
蔒	hunUN
鳸	huNV
俒	hunVM
倱	hunVN
珲	hunW
鶦	huNWL
琿	hunWM
圂	hunWN
鶮	huNX
忶	hunXM
惛	hunXN
惽	hunXO
尡	hunXP
慁	hunXQ
诨	hunY
諢	hunYM
呼	huO
攉	huoA
捇	huoAM
掝	huoAN
擭	huoAO
货	huoB
唬	huOBL
貨	huoBM
癨	huoBN
唿	huOC
蠖	huoCL
劐	huoD
剨	huoDM
奯	huoDN
活	huoE
沎	huoEM
湱	huoEN
漷	huoEO
濩	huoEP
濊	huoEQ
瀖	huoER
邩	huoFM
或	huoG
豁	huoGB
韄	huoGM
火	huoH
和	huoHB
灬	huoHC
秮	huoHM
秳	huoHN
秴	huoHO
煷	huoHP
穫	huoHQ
檴	huoIM
钬	huoJ
镬	huoJB
锪	huoJC
鈥	huoJM
鍃	huoJN
鑊	huoJO
旤	huoJP
篧	huoKM
耠	huoL
膕	huoLM
耯	huoLN
臛	huoLO
咊	huOM
眓	huoMM
閄	huoMN
矆	huoMO
騞	huoMP
矐	huoMQ
喖	huON
姡	huoNM
嚯	huoO
嗀	huOOL
吙	huoOM
咊	huoON
咟	huoOO
喐	huoOP
嗀	huoOQ
嚄	huoOR
嚿	huoOS
嗃	huOP
乊	huoPM
礊	huoPN
嘑	huOQ
獲	huoQM
霍	huoR
嘝	huORL
曤	huoRM
靃	huoRN
祸	huoS
嚛	huOSL
禍	huoSM
豰	huoSN
获	huoU
藿	huoUB
蒦	huoUM
伙	huoV
佸	huoVM
俰	huoVN
惑	huoX
夥	huoXB
窢	huoXM
彟	huoXN
彠	huoXO
謋	huoYM
趏	huoZM
雘	huoZN
艧	huoZO
乎	huP
觳	huPB
乕	huPM
礐	huPN
狐	huQ
醐	huQB
猢	huQC
歑	huQM
昒	huRM
昈	huRN
曶	huRO
雽	huRP
壶	huS
祜	huSB
岵	huSC
壺	huSM
壷	huSN
豰	huSO
餬	huSP
垀	huTM
葫	huU
芐	huUM
苸	huUN
芔	huUO
萀	huUP
蔛	huUQ
蔰	huUR
乯	huVM
俿	huVN
僱	huVO
瑚	huW
琥	huWB
囫	huWC
瓳	huWM
忽	huX
惚	huXB
怙	huXC
怘	huXM
恗	huXN
许	huY
許	huYM
護	huYN
魱	huYO
頶	huYP
謼	huYQ
鯱	huYR
鰗	huYS
鳠	huYT
頀	huYU
鱯	huYV
隺	huZM
雐	huZN
技	jiA
挾	jiaAM
扴	jiaAN
抸	jiaAO
拁	jiaAP
擖	jiaAQ
家	jiaB
贾	jiaBB
痂	jiaBC
瘕	jiaBD
挤	jiABL
賈	jiaBM
宊	jiaBN
蛱	jiaC
掎	jiACL
蛺	jiaCM
徍	jiaCN
徦	jiaCO
夹	jiaD
夾	jiaDM
斚	jiaDN
斝	jiaDO
浃	jiaE
浹	jiaEM
泇	jiaEN
郏	jiaF
郟	jiaFM
纐	jiaFN
戛	jiaG
戞	jiaGM
稼	jiaH
架	jiaI
枷	jiaIB
梜	jiaIM
椵	jiaIN
槚	jiaIO
榎	jiaIP
榢	jiaIQ
檟	jiaIR
钾	jiaJ
铗	jiaJB
镓	jiaJC
鉀	jiaJM
鋏	jiaJN
鎵	jiaJO
幏	jiaJP
鉫	jiaJQ
袈	jiaK
笳	jiaKB
裌	jiaKM
筴	jiaKN
加	jiaL
胛	jiaLB
耞	jiaLM
脥	jiaLN
腵	jiaLO
麚	jiaLP
驾	jiaM
擠	jiAML
駕	jiaMM
毠	jiaMN
糘	jiaMO
嫁	jiaN
捡	jianA
拣	jianAB
搛	jianAC
揀	jianAM
撿	jianAN
挸	jianAO
揵	jianAP
揃	jianAQ
擶	jianAR
攕	jianAS
减	jianB
兼	jianBB
贱	jianBC
賤	jianBM
冿	jianBN
寋	jianBO
賎	jianBP
鬋	jianBQ
徤	jianCM
螹	jianCN
蠒	jianCO
轞	jianCP
剑	jianD
歼	jianDB
剪	jianDC
劍	jianDM
殲	jianDN
剣	jianDO
剱	jianDP
劎	jianDQ
劒	jianDR
劔	jianDS
殱	jianDT
劗	jianDU
渐	jianE
浅	jianEB
溅	jianEC
涧	jianED
湔	jianEE
淺	jianEM
減	jianEN
漸	jianEO
澗	jianEP
濺	jianEQ
洊	jianER
湕	jianES
瀐	jianET
瀳	jianEU
瀸	jianEV
瀽	jianEW
缄	jianF
缣	jianFB
緘	jianFM
繭	jianFN
縑	jianFO
旔	jianFP
絸	jianFQ
繝	jianFR
聻	jianFS
艰	jianG
摪	jiangAM
摾	jiangAN
戬	jianGB
虹	jiangC
鞯	jianGCL
將	jiangCM
螀	jiangCN
螿	jiangCO
奖	jiangD
豇	jiangDB
戋	jianGDL
奨	jiangDM
奬	jiangDN
殭	jiangDO
江	jiangE
浆	jiangEB
洚	jiangEC
漿	jiangEM
滰	jiangEN
降	jiangF
匠	jiangFB
缰	jiangFC
绛	jiangFD
絳	jiangFM
匞	jiangFN
繮	jiangFO
强	jiangG
強	jiangGM
韁	jiangGN
弜	jiangGO
弶	jiangGP
彊	jiangGQ
桨	jiangI
槳	jiangIM
杢	jiangIN
橿	jiangIO
櫤	jiangIP
袶	jiangKM
耩	jiangL
勥	jiangLM
膙	jiangLN
糨	jiangM
艱	jianGML
糡	jiangMM
姜	jiangN
犟	jiangNB
戔	jianGNL
戩	jianGO
将	jiangP
礓	jiangPB
丬	jiangPC
韉	jianGPL
酱	jiangQ
靓	jiangQB
幵	jianGQL
獎	jiangQM
醬	jiangQN
醤	jiangQO
靬	jianGR
弿	jianGS
嵹	jiangSM
疆	jiangT
彅	jianGTL
畕	jiangTM
塂	jiangTN
畺	jiangTO
壃	jiangTP
疅	jiangTQ
蒋	jiangU
茳	jiangUB
鞬	jianGUL
蔣	jiangUM
葁	jiangUN
薑	jiangUO
僵	jiangV
韀	jianGVL
傋	jiangVM
讲	jiangY
講	jiangYM
翞	jiangYN
鳉	jiangYO
顜	jiangYP
謽	jiangYQ
鱂	jiangYR
夅	jiangZM
煎	jianH
稴	jianHM
熞	jianHN
熸	jianHO
检	jianI
柬	jianIB
槛	jianIC
楗	jianID
枧	jianIE
檢	jianIM
檻	jianIN
梘	jianIO
栫	jianIP
検	jianIQ
椷	jianIR
椾	jianIS
榗	jianIT
樫	jianIU
橏	jianIV
櫼	jianIW
见	jianJ
键	jianJB
鉴	jianJC
锏	jianJD
見	jianJM
鍵	jianJN
鑒	jianJO
鐧	jianJP
帴	jianJQ
釰	jianJR
釼	jianJS
鋄	jianJT
鏩	jianJTL
鋑	jianJU
鐗	jianJUL
鋻	jianJV
鐱	jianJVL
鍳	jianJW
鑑	jianJWL
鎫	jianJX
鑬	jianJXL
覸	jianJY
鑯	jianJYL
覵	jianJZ
鑳	jianJZL
简	jianK
箭	jianKB
笺	jianKC
笕	jianKD
裥	jianKE
箋	jianKM
簡	jianKN
筧	jianKO
襇	jianKP
袸	jianKQ
篯	jianKR
襉	jianKS
籈	jianKT
籛	jianKU
襺	jianKV
肩	jianL
腱	jianLB
擊	jiANLL
鹹	jianLM
鹼	jianLN
麉	jianLO
鹸	jianLP
鹻	jianLQ
间	jianM
监	jianMB
睑	jianMC
毽	jianMD
婽	jiaNML
間	jianMM
監	jianMN
瞼	jianMO
閒	jianMP
睷	jianMQ
糋	jianMR
瞷	jianMS
瞯	jianMT
奸	jianN
犍	jianNB
鹣	jianNC
牮	jianND
犌	jiaNNL
鵑	jianNM
鶼	jianNN
姧	jianNO
姦	jianNP
鳽	jianNQ
鵳	jianNR
鴐	jiaNO
囏	jianOM
碱	jianP
硷	jianPB
鴶	jiaNPL
牋	jianPM
碊	jianPN
磵	jianPO
礀	jianPP
礆	jianPQ
礛	jianPR
礷	jianPS
鵊	jiaNQ
猏	jianQM
朁	jianRM
暕	jianRN
饯	jianS
餞	jianSM
豜	jianSN
豣	jianSO
餰	jianSP
坚	jianT
堅	jianTM
堿	jianTN
塹	jianTO
墹	jianTP
荐	jianU
茧	jianUB
菅	jianUC
蒹	jianUD
薦	jianUM
菺	jianUN
葌	jianUO
蔪	jianUP
蕳	jianUQ
蕑	jianUR
藆	jianUS
虃	jianUT
件	jianV
健	jianVB
俭	jianVC
僭	jianVD
儉	jianVM
俴	jianVN
倹	jianVO
偂	jianVP
傔	jianVQ
僣	jianVR
囝	jianW
玪	jianWM
珔	jianWN
瑊	jianWO
瑐	jianWP
尖	jianX
惤	jianXM
馢	jianXN
建	jianY
谏	jianYB
翦	jianYC
謇	jianYD
鲣	jianYE
谫	jianYF
諫	jianYM
鰹	jianYN
譾	jianYO
詃	jianYP
諓	jianYQ
鳒	jianYR
謭	jianYS
鰎	jianYT
譛	jianYU
鰔	jianYV
譼	jianYW
鰜	jianYX
舰	jianZ
践	jianZB
蹇	jianZC
踺	jianZD
趼	jianZE
踐	jianZM
艦	jianZN
雃	jianZO
臶	jianZP
跈	jianZQ
趝	jianZR
嘉	jiaO
搅	jiaoA
挢	jiaoAB
攪	jiaoAM
撟	jiaoAN
挍	jiaoAO
捁	jiaoAP
摎	jiaoAQ
摷	jiaoAR
撹	jiaoAS
皎	jiaoB
嘏	jiaOBL
賋	jiaoBM
癄	jiaoBN
皦	jiaoBO
皭	jiaoBP
较	jiaoC
蛟	jiaoCB
轿	jiaoCC
徼	jiaoCD
較	jiaoCM
轎	jiaoCN
徺	jiaoCO
轇	jiaoCP
蟜	jiaoCQ
蟭	jiaoCR
剿	jiaoD
斠	jiaoDM
劋	jiaoDN
浇	jiaoE
湫	jiaoEB
澆	jiaoEM
湬	jiaoEN
滘	jiaoEO
漖	jiaoEP
潐	jiaoEQ
灂	jiaoER
灚	jiaoES
绞	jiaoF
郊	jiaoFB
缴	jiaoFC
絞	jiaoFM
繳	jiaoFN
纐	jiaoFO
焦	jiaoH
爝	jiaoHB
烄	jiaoHM
煍	jiaoHN
虠	jiaoHO
燋	jiaoHP
穚	jiaoHQ
校	jiaoI
椒	jiaoIB
樔	jiaoIM
角	jiaoJ
觉	jiaoJB
铰	jiaoJC
鉸	jiaoJM
覺	jiaoJN
覐	jiaoJO
釥	jiaoJP
覚	jiaoJQ
鐎	jiaoJR
笅	jiaoKM
筊	jiaoKN
簥	jiaoKO
脚	jiaoL
胶	jiaoLB
揤	jiAOLL
腳	jiaoLM
膠	jiaoLN
勦	jiaoLO
膲	jiaoLP
骄	jiaoM
唊	jiaOML
驕	jiaoMM
娇	jiaoN
姣	jiaoNB
鹪	jiaoNC
嗧	jiaONL
嬌	jiaoNM
鷦	jiaoNN
嬓	jiaoNO
鵁	jiaoNP
鵤	jiaoNQ
孂	jiaoNR
鷮	jiaoNS
叫	jiaoO
嚼	jiaoOB
噍	jiaoOC
喬	jiaoOM
呌	jiaoON
嘂	jiaoOO
嘄	jiaoOP
嘦	jiaoOQ
嘐	jiaoOR
噭	jiaoOS
礁	jiaoP
狡	jiaoQ
酵	jiaoQB
醮	jiaoQC
獥	jiaoQM
釂	jiaoQN
晈	jiaoRM
暞	jiaoRN
曒	jiaoRO
矫	jiaoS
饺	jiaoSB
峤	jiaoSC
餃	jiaoSM
矯	jiaoSN
嶠	jiaoSO
峧	jiaoSP
嶕	jiaoSQ
嶣	jiaoSR
交	jiaoT
蕉	jiaoU
茭	jiaoUB
艽	jiaoUC
茮	jiaoUM
藠	jiaoUN
侥	jiaoV
佼	jiaoVB
僬	jiaoVC
僥	jiaoVM
儌	jiaoVN
教	jiaoW
敫	jiaoWB
珓	jiaoWM
敎	jiaoWN
斍	jiaoWO
敽	jiaoWP
敿	jiaoWQ
璬	jiaoWR
窖	jiaoX
恔	jiaoXM
悎	jiaoXN
窌	jiaoXO
憢	jiaoXP
憍	jiaoXQ
憿	jiaoXR
鲛	jiaoY
鮫	jiaoYM
訆	jiaoYN
譑	jiaoYO
譥	jiaoYP
鱎	jiaoYQ
龣	jiaoYR
跤	jiaoZ
臫	jiaoZM
踋	jiaoZN
趭	jiaoZO
摖	jiAP
撠	jiAQ
猰	jiaQM
猳	jiaQN
撃	jiAR
岬	jiaS
撽	jiASL
豭	jiaSM
甲	jiaT
圿	jiaTM
埉	jiaTN
茄	jiaU
葭	jiaUB
荚	jiaUC
莢	jiaUM
价	jiaV
假	jiaVB
佳	jiaVC
伽	jiaVD
價	jiaVM
乫	jiaVN
傢	jiaVO
珈	jiaW
玾	jiaWM
恝	jiaX
忦	jiaXM
颊	jiaY
頰	jiaYM
頡	jiaYN
叚	jiaYO
頬	jiaYP
迦	jiaZ
跏	jiaZB
跲	jiaZM
貑	jiaZN
疾	jiB
寂	jiBB
寄	jiBC
冀	jiBD
髻	jiBE
瘠	jiBF
其	jiBG
赍	jiBH
賫	jiBM
屰	jiBN
皀	jiBO
皍	jiBP
痵	jiBQ
兾	jiBR
賷	jiBS
癠	jiBT
癪	jiBU
辑	jiC
虮	jiCB
輯	jiCM
蟣	jiCN
彶	jiCO
徛	jiCP
蝍	jiCQ
螏	jiCR
蠀	jiCS
轚	jiCT
剂	jiD
奇	jiDB
殛	jiDC
剞	jiDD
劑	jiDM
刉	jiDN
刏	jiDO
剤	jiDP
济	jiE
接	jieA
捷	jieAB
揭	jieAC
拮	jieAD
扢	jieAM
掲	jieAN
掶	jieAO
搩	jieAP
擑	jieAQ
擳	jieAR
擮	jieAS
皆	jieB
疥	jieBB
疖	jieBC
家	jieBD
激	jiEBL
癤	jieBM
痎	jieBN
街	jieC
蚧	jieCB
汲	jiECL
徣	jieCM
蛣	jieCN
蜐	jieCO
蛶	jieCP
蝍	jieCQ
镼	jieCR
蝔	jieCS
蠞	jieCT
蠘	jieCU
蠽	jieCV
洎	jiED
刦	jieDM
刧	jieDN
刼	jieDO
洁	jieE
潔	jieEM
洯	jieEN
湝	jieEO
滐	jieEP
结	jieF
阶	jieFB
階	jieFM
結	jieFN
斺	jieFO
紒	jieFP
絜	jieFQ
戒	jieG
截	jieGB
骱	jieGC
庎	jieGM
鞂	jieGN
鞊	jieGO
秸	jieH
稭	jieHM
煯	jieHN
杰	jieI
桀	jieIB
楷	jieIC
桔	jieID
杢	jieIM
桝	jieIN
椄	jieIO
楬	jieIP
楐	jieIQ
楶	jieIR
榤	jieIS
檞	jieIT
解	jieJ
卩	jieJB
卪	jieJM
鉣	jieJN
觧	jieJO
幯	jieJP
鍻	jieJQ
鎅	jieJR
節	jieKM
衱	jieKN
衸	jieKO
袓	jieKP
袺	jieKQ
裓	jieKR
褯	jieKS
劫	jieL
竭	jieLB
丯	jieLM
劼	jieLN
脻	jieLO
耤	jieLP
睫	jieM
阂	jieMB
濟	jiEML
毑	jieMM
姐	jieN
婕	jieNB
汥	jiENL
妎	jieNM
媎	jieNN
媘	jieNO
媫	jieNP
嫅	jieNQ
犗	jieNR
鶛	jieNS
鶡	jieNT
嗟	jieO
喈	jieOB
泲	jiEOL
嚌	jieOM
吤	jieON
唶	jieOO
啑	jieOP
喼	jieOQ
届	jieP
碣	jiePB
済	jiEPL
屆	jiePM
砎	jiePN
礍	jiePO
淁	jiEQ
狤	jieQM
湒	jiER
昅	jieRM
曁	jieRN
漈	jiES
岕	jieSM
岊	jieSN
崨	jieSO
嵑	jieSP
嵥	jieSQ
飷	jieSR
嶱	jieSS
嶰	jieST
嶻	jieSU
巀	jieSV
界	jieT
漃	jiETL
畍	jieTM
堦	jieTN
堺	jieTO
节	jieU
藉	jieUB
芥	jieUC
濈	jiEUL
莭	jieUM
菨	jieUN
蓵	jieUO
借	jieV
介	jieVB
偈	jieVC
价	jieVD
潗	jiEVL
傑	jieVM
價	jieVN
倢	jieVO
偼	jieVP
瀱	jiEW
玠	jieWM
瑎	jieWN
琾	jieWO
尐	jieXM
悈	jieXN
诫	jieY
颉	jieYB
羯	jieYC
诘	jieYD
讦	jieYE
鲒	jieYF
誡	jieYM
訐	jieYN
詰	jieYO
頡	jieYP
鮚	jieYQ
魪	jieYR
誱	jieYS
謯	jieYT
孑	jieZ
疌	jieZM
迼	jieZN
趌	jieZO
跲	jieZP
踕	jieZQ
级	jiF
继	jiFB
纪	jiFC
际	jiFD
绩	jiFE
缉	jiFF
给	jiFG
系	jiFH
級	jiFM
紀	jiFN
給	jiFO
際	jiFP
緝	jiFQ
績	jiFR
繼	jiFS
郆	jiFT
紒	jiFU
継	jiFV
綨	jiFW
緁	jiFX
隮	jiFY
繋	jiFZ
繫	jiFZL
既	jiG
戟	jiGB
革	jiGC
戢	jiGD
谻	jiGM
庴	jiGN
鬾	jiGO
鞊	jiGP
廭	jiGQ
鞿	jiGR
魕	jiGS
积	jiH
稽	jiHB
稷	jiHC
亟	jiHD
嵇	jiHE
丌	jiHF
積	jiHM
焏	jiHN
稘	jiHO
稩	jiHP
穊	jiHQ
穄	jiHR
穖	jiHS
穧	jiHT
机	jiI
极	jiIB
棘	jiIC
楫	jiID
極	jiIM
機	jiIN
枅	jiIO
楖	jiIP
梞	jiIQ
槉	jiIR
樭	jiIS
槣	jiIT
橶	jiIU
檝	jiIV
檕	jiIW
櫅	jiIX
櫭	jiIY
檵	jiIZ
几	jiJ
己	jiJB
即	jiJC
觊	jiJD
覘	jiJM
覬	jiJN
覿	jiJO
鏶	jiJOL
旡	jiJP
鐖	jiJPL
卽	jiJQ
鑇	jiJQL
觙	jiJR
鑙	jiJRL
帺	jiJS
旣	jiJT
銈	jiJU
銡	jiJV
觭	jiJW
錤	jiJX
鍓	jiJY
韲	jiJZ
击	jiK
籍	jiKB
笈	jiKC
箕	jiKD
笄	jiKE
筓	jiKM
裚	jiKN
箿	jiKO
襀	jiKP
簎	jiKQ
簊	jiKR
襋	jiKS
肌	jiL
脊	jiLB
期	jiLC
麂	jiLD
丮	jiLM
朞	jiLN
勣	jiLO
耤	jiLP
膌	jiLQ
耭	jiLR
骑	jiM
骥	jiMB
驥	jiMM
瞉	jiMN
鸡	jiN
搢	jinAM
嫉	jiNB
赆	jinBL
贐	jinBM
寖	jinBN
凚	jinBO
賮	jinBP
姬	jiNC
厪	jinCM
齽	jinCN
妓	jiND
殣	jinDM
津	jinE
浸	jinEB
犄	jiNEL
兓	jinEM
浕	jinEN
溍	jinEO
漌	jinEP
濅	jinEQ
濜	jinER
紧	jinF
缙	jinFB
緊	jinFM
縉	jinFN
紟	jinFO
靳	jinG
擏	jingAM
净	jingB
痉	jingBB
廑	jinGBL
凈	jingBM
痙	jingBN
宑	jingBO
径	jingC
徑	jingCM
巠	jingCN
蟼	jingCO
荆	jingD
刭	jingDB
剄	jingDM
丼	jingDN
殑	jingDO
殌	jingDP
泾	jingE
涇	jingEM
汫	jingEN
汬	jingEO
浄	jingEP
淨	jingEQ
澋	jingER
瀞	jingES
经	jingF
阱	jingFB
旌	jingFC
經	jingFM
旍	jingFN
経	jingFO
聙	jingFP
綡	jingFQ
弪	jingG
弳	jingGM
井	jingH
秔	jingHM
稉	jingHN
桱	jingIM
梷	jingIN
橸	jingIO
镜	jingJ
鏡	jingJM
幜	jingJN
鋞	jingJO
兢	jingK
箐	jingKB
竟	jingL
劲	jingLB
竞	jingLC
靖	jingLD
胫	jingLE
肼	jingLF
腈	jingLG
勁	jingLM
競	jingLN
脛	jingLO
劤	jingLP
竫	jingLQ
竧	jingLR
麖	jingLS
竸	jingLT
麠	jingLU
精	jingM
睛	jingMB
粳	jingMC
驚	jingMM
粇	jingMN
婧	jingN
妌	jingNM
婙	jingNN
婛	jingNO
鵛	jingNP
鶄	jingNQ
鶁	jingNR
静	jingQ
靓	jingQB
獍	jingQC
靜	jingQM
靚	jingQN
獷	jingQO
猄	jingQP
景	jingR
晶	jingRB
曔	jingRM
暻	jingRN
鼱	jingSM
京	jingT
境	jingTB
坓	jingTM
坙	jingTN
坕	jingTO
亰	jingTP
菁	jingU
茎	jingUB
荊	jingUM
莖	jingUN
葏	jingUO
儆	jingV
俓	jingVM
倞	jingVN
傹	jingVO
敬	jingW
璄	jingWM
璥	jingWN
璟	jingWO
惊	jingX
憬	jingXB
穽	jingXM
憼	jingXN
警	jingY
颈	jingYB
鲸	jingYC
頸	jingYM
鯨	jingYN
誩	jingYO
頚	jingYP
迳	jingZ
逕	jingZM
踁	jingZN
烬	jinH
燼	jinHM
煡	jinHN
黅	jinHO
槿	jinI
枃	jinIM
榗	jinIN
金	jinJ
锦	jinJB
巾	jinJC
斤	jinJD
觐	jinJE
卺	jinJF
钅	jinJG
錦	jinJM
巹	jinJN
覲	jinJO
釒	jinJP
觔	jinJQ
釿	jinJR
筋	jinK
襟	jinKB
衿	jinKC
竻	jinKM
笒	jinKN
劲	jinL
勁	jinLM
劤	jinLN
鹶	jinLO
矜	jinM
乁	jiNML
盡	jinMM
矝	jinMN
馸	jinMO
妗	jinN
妀	jiNNL
婜	jinNM
嫤	jinNN
嬐	jinNO
嬧	jinNP
噤	jinO
姞	jiNOL
唫	jinOM
嚍	jinON
尽	jinP
鳮	jiNPL
砛	jinPM
鹡	jiNQ
歏	jinQM
晋	jinR
鵋	jiNRL
晉	jinRM
禁	jinS
馑	jinSB
鶏	jiNSL
饉	jinSM
祲	jinSN
堇	jinT
鷄	jiNTL
埐	jinTM
堻	jinTN
墐	jinTO
壗	jinTP
荩	jinU
鶺	jiNUL
藎	jinUM
荕	jinUN
菫	jinUO
菳	jinUP
蓳	jinUQ
今	jinV
仅	jinVB
鷑	jiNVL
僅	jinVM
仐	jinVN
伒	jinVO
侭	jinVP
僸	jinVQ
儘	jinVR
瑾	jinW
鸄	jiNWL
珒	jinWM
琎	jinWN
琻	jinWO
瑨	jinWP
璡	jinWQ
璶	jinWR
惍	jinXM
慬	jinXN
谨	jinY
謹	jinYM
进	jinZ
近	jinZB
進	jinZM
臸	jinZN
吉	jiO
叽	jiOB
唧	jiOC
咭	jiOD
哜	jiOE
嘰	jiOM
嚌	jiON
臦	jiongCM
臩	jiongCN
泂	jiongEM
浻	jiongEN
澃	jiongEO
絅	jiongFM
綗	jiongFN
炯	jiongH
炅	jiongHB
扃	jiongHC
扄	jiongHM
烱	jiongHN
煚	jiongHO
煛	jiongHP
熲	jiongHQ
燛	jiongHR
銄	jiongJM
褧	jiongKM
駉	jiongMM
駫	jiongMN
昋	jiongRM
冂	jiongT
坰	jiongTM
冋	jiongTN
冏	jiongTO
埛	jiongTP
蘏	jiongUM
蘔	jiongUN
侰	jiongVM
僒	jiongVN
囧	jiongWM
窘	jiongX
颎	jiongYM
顈	jiongYN
迥	jiongZ
逈	jiongZM
吇	jiOO
喞	jiOP
嗘	jiOQ
及	jiP
矶	jiPB
屐	jiPC
磯	jiPM
硛	jiPN
毄	jiPO
磼	jiPP
齊	jiQM
齏	jiQN
犱	jiQO
齌	jiQP
齎	jiQQ
霁	jiR
暨	jiRB
霽	jiRM
暩	jiRN
曁	jiRO
霵	jiRP
祭	jiS
饥	jiSB
羁	jiSC
岌	jiSD
嵴	jiSE
饑	jiSM
羈	jiSN
岋	jiSO
飢	jiSP
卙	jiSQ
嵆	jiSR
禝	jiSS
嶯	jiST
躸	jiSU
禨	jiSV
罽	jiSW
羇	jiSX
基	jiT
圾	jiTB
畿	jiTC
畸	jiTD
墼	jiTE
坖	jiTM
垍	jiTN
畟	jiTO
堲	jiTP
塈	jiTQ
塉	jiTR
藉	jiU
揪	jiuA
捄	jiuAM
揂	jiuAN
揫	jiuAO
摎	jiuAP
疚	jiuB
鬏	jiuBB
蓟	jiUBL
勼	jiuBM
匓	jiuBN
厩	jiuC
蒺	jiUCL
镹	jiuCM
齨	jiuCN
芨	jiUD
鬮	jiuDM
剹	jiuDN
殧	jiuDO
酒	jiuE
荠	jiUEL
氿	jiuEM
汣	jiuEN
纠	jiuF
芰	jiUFL
糾	jiuFM
匛	jiuFN
糺	jiuFO
紤	jiuFP
匶	jiuFQ
蕺	jiUG
廄	jiuGM
廐	jiuGN
廏	jiuGO
灸	jiuH
稵	jiuHM
柩	jiuI
桕	jiuIB
朻	jiuIM
杦	jiuIN
柾	jiuIO
樛	jiuIP
欍	jiuIQ
舅	jiuJ
臼	jiuJB
韭	jiuJC
舊	jiuJM
韮	jiuJN
丩	jiuLM
麔	jiuLN
阄	jiuM
茍	jiUML
鹫	jiuN
鸠	jiuNB
薊	jiUNL
鳩	jiuNM
鷲	jiuNN
牞	jiuNO
奺	jiuNP
咎	jiuO
啾	jiuOB
薺	jiUOL
九	jiuP
久	jiuPB
苙	jiUPL
乆	jiuPM
茤	jiUQ
旧	jiuR
葪	jiURL
蔇	jiUS
舏	jiuSM
蕀	jiUT
蘎	jiUU
萛	jiuUM
僦	jiuV
蘮	jiUVL
乣	jiuVM
倃	jiuVN
救	jiuW
玖	jiuWB
蘻	jiUWL
究	jiuX
虀	jiUXL
慦	jiuXM
就	jiuY
鯦	jiuYM
赳	jiuZ
蹵	jiuZM
伎	jiV
佶	jiVB
偈	jiVC
乩	jiVD
亼	jiVM
亽	jiVN
伋	jiVO
偮	jiVP
僟	jiVQ
玑	jiW
齑	jiWB
璣	jiWM
敧	jiWN
璾	jiWO
急	jiX
忌	jiXB
悸	jiXC
彑	jiXM
尐	jiXN
忣	jiXO
惎	jiXP
愱	jiXQ
憿	jiXR
懠	jiXS
懻	jiXT
覉	jiXU
覊	jiXV
记	jiY
计	jiYB
讥	jiYC
诘	jiYD
鲫	jiYE
鲚	jiYF
計	jiYM
記	jiYN
幾	jiYO
譏	jiYP
詰	jiYQ
鯽	jiYR
鱭	jiYS
諆	jiYSL
叝	jiYT
諔	jiYTL
鱾	jiYU
鮆	jiYUL
魝	jiYV
鯚	jiYVL
魥	jiYW
譤	jiYWL
魢	jiYX
鱀	jiYXL
誋	jiYY
鰿	jiYYL
諅	jiYZ
鰶	jiYZL
集	jiZ
迹	jiZB
季	jiZC
跻	jiZD
跽	jiZE
跡	jiZM
雞	jiZN
躋	jiZO
攲	jiZP
臮	jiZQ
趌	jiZR
趞	jiZS
踑	jiZT
踖	jiZU
蹐	jiZV
蹟	jiZW
艥	jiZX
躤	jiZY
雧	jiZZ
据	juA
拒	juAB
拘	juAC
掬	juAD
據	juAM
抅	juAN
捐	juanA
捲	juanAM
蠲	juanC
奆	juanDM
奍	juanDN
涓	juanE
淃	juanEM
绢	juanF
鄄	juanFB
絹	juanFM
絭	juanFN
縳	juanFO
弮	juanGM
鞙	juanGN
焆	juanHM
桊	juanI
棬	juanIM
梋	juanIN
椦	juanIO
卷	juanJ
镌	juanJB
锩	juanJC
錈	juanJM
鐫	juanJN
帣	juanJO
巻	juanJP
鋗	juanJQ
鋑	juanJR
鎸	juanJS
裐	juanKM
脧	juanLM
劵	juanLN
勌	juanLO
朘	juanLP
腃	juanLQ
勬	juanLR
臇	juanLS
眷	juanM
睊	juanMM
睠	juanMN
闂	juanMO
娟	juanN
鹃	juanNB
鵑	juanNM
姢	juanNN
婘	juanNO
呟	juanOM
狷	juanQ
獧	juanQM
罥	juanSM
飬	juanSN
嶲	juanSO
餋	juanSP
羂	juanSQ
巂	juanSR
埍	juanTM
菤	juanUM
蔨	juanUN
倦	juanV
圈	juanW
瓹	juanWM
圏	juanWN
悁	juanXM
惓	juanXN
慻	juanXO
讂	juanYM
隽	juanZ
雋	juanZM
踡	juanZN
拠	juAO
捄	juAP
挶	juAQ
挙	juAR
揟	juAS
擧	juAT
具	juB
疽	juBB
匊	juBM
痀	juBN
寠	juBO
车	juC
龃	juCB
車	juCM
齟	juCN
蚷	juCO
輂	juCP
蜛	juCQ
螶	juCR
忂	juCS
举	juD
剧	juDB
劇	juDM
沮	juE
掘	jueA
撅	jueAB
抉	jueAC
攫	jueAD
挗	jueAM
捔	jueAN
撧	jueAO
决	jueB
疦	jueBM
瘚	jueBN
厥	jueC
虳	jueCM
蚗	jueCN
镼	jueCO
蟨	jueCP
蟩	jueCQ
劂	jueD
刔	jueDM
殌	jueDN
決	jueEM
泬	jueEN
灍	jueEO
绝	jueF
絕	jueFM
絶	jueFN
繘	jueFO
匷	jueFP
弡	jueGM
髉	jueGN
彏	jueGO
爝	jueH
焳	jueHM
熦	jueHN
燋	jueHO
爑	jueHP
穱	jueHQ
橛	jueI
桷	jueIB
橜	jueIM
櫭	jueIN
觉	jueJ
角	jueJB
镢	jueJC
觖	jueJD
覺	jueJM
鐝	jueJN
覐	jueJO
鈌	jueJP
覚	jueJQ
觮	jueJR
鐍	jueJS
觼	jueJT
钁	jueJU
袦	jueKM
脚	jueL
臄	jueLM
洰	juEM
闕	jueMM
矞	jueMN
駃	jueMO
矡	jueMP
泃	juEN
妜	jueNM
鴃	jueNN
鴂	jueNO
鷢	jueNP
嚼	jueO
噘	jueOB
噱	jueOC
泦	juEOL
吷	jueOM
噊	jueON
淗	juEP
砄	juePM
瑴	juePN
屩	juePO
屫	juePP
獗	jueQ
涺	juEQL
欮	jueQM
玃	jueQN
湨	juER
崛	jueS
澽	juESL
氒	jueSM
崫	jueSN
嶡	jueSO
嶥	jueSP
埆	jueTM
壆	jueTN
蕨	jueU
芵	jueUM
蕝	jueUN
倔	jueV
亅	jueVM
傕	jueVN
珏	jueW
玨	jueWM
玦	jueWN
斍	jueWO
璚	jueWP
憰	jueXM
憠	jueXN
戄	jueXO
诀	jueY
谲	jueYB
矍	jueYC
廴	jueYD
訣	jueYM
譎	jueYN
鱖	jueYO
叕	jueYP
誳	jueYQ
爵	jueZ
蹶	jueZB
孓	jueZC
孒	jueZM
赽	jueZN
趹	jueZO
趉	jueZP
爴	jueZQ
蹷	jueZR
蹻	jueZS
躩	jueZT
貜	jueZU
巨	juF
聚	juFB
飓	juFC
颶	juFM
巪	juFN
邭	juFO
陱	juFP
郹	juFQ
聥	juFR
繘	juFS
鞠	juG
鞫	juGB
弆	juGM
且	juH
炬	juHB
秬	juHM
焗	juHN
焣	juHO
虡	juHP
橘	juI
桔	juIB
榉	juIC
柜	juID
枸	juIE
椐	juIF
榘	juIG
櫸	juIM
櫃	juIN
梮	juIO
椇	juIP
椈	juIQ
檋	juIR
欅	juIS
锯	juJ
钜	juJB
锔	juJC
舉	juJM
鋸	juJN
鉅	juJO
鋦	juJP
凥	juJQ
鐻	juJR
裾	juK
袓	juKM
筥	juKN
簴	juKO
籧	juKP
襷	juKQ
耟	juLM
腒	juLN
勮	juLO
驹	juM
駒	juMM
眗	juMN
毩	juMO
粔	juMP
毱	juMQ
駏	juMR
閰	juMS
粷	juMT
駶	juMU
驧	juMV
犋	juN
捃	junA
攈	junAM
攟	junAN
賐	junBM
寯	junBN
軍	junCM
蚐	junCN
蜠	junCO
浚	junE
汮	junEM
濬	junEN
郡	junF
陖	junFM
龟	junG
龜	junGM
焌	junHM
燇	junHN
桾	junIM
棞	junIN
钧	junJ
鈞	junJM
銁	junJN
銞	junJO
覠	junJP
鍕	junJQ
筠	junK
袀	junKM
箟	junKN
箘	junKO
竣	junL
麇	junLB
麏	junLM
麕	junLN
军	junM
骏	junMB
姖	juNML
駿	junMM
娵	juNN
姰	junNM
鵔	junNN
鵘	junNO
鵕	junNP
君	junO
婅	juNOL
呁	junOM
皲	junP
婮	juNPL
皸	junPM
碅	junPN
皹	junPO
犑	juNQ
鴡	juNR
晙	junRM
峻	junS
鵙	juNSL
馂	junSM
餕	junSN
均	junT
鵴	juNTL
埈	junTM
畯	junTN
菌	junU
鶋	juNUL
莙	junUM
葰	junUN
蔨	junUO
俊	junV
鶪	juNVL
儁	junVM
珺	junWM
懏	junXM
鲪	junYM
頵	junYN
鮶	junYO
隽	junZ
雋	junZM
句	juO
咀	juOB
啹	juOM
局	juP
居	juPB
屦	juPC
屨	juPM
砠	juPN
狙	juQ
醵	juQB
狊	juQM
昛	juRM
矩	juS
岠	juSM
岨	juSN
罝	juSO
崌	juSP
豦	juSQ
躹	juSR
巈	juSS
鼰	juST
鼳	juSU
埧	juTM
埾	juTN
壉	juTO
菊	juU
莒	juUB
苴	juUC
苣	juUD
蒩	juUM
蒟	juUN
蓻	juUO
蘜	juUP
俱	juV
倨	juVB
乬	juVM
伡	juVN
俥	juVO
侷	juVP
倶	juVQ
僪	juVR
琚	juW
珇	juWM
惧	juX
窭	juXB
懼	juXM
窶	juXN
怇	juXO
怚	juXP
怐	juXQ
愳	juXR
懅	juXS
讵	juY
詎	juYM
鮔	juYN
諊	juYO
鮈	juYP
距	juZ
踞	juZB
趄	juZC
遽	juZD
踽	juZE
雎	juZF
歫	juZM
跙	juZN
跔	juZO
跼	juZP
艍	juZQ
趜	juZR
踘	juZS
貗	juZT
蹫	juZU
躆	juZV
侷	jvVM
擖	kaAM
揩	kaiA
輆	kaiCM
剀	kaiD
豈	kaiDM
剴	kaiDN
奒	kaiDO
濭	kaiEM
颽	kaiFM
开	kaiG
炌	kaiHM
烗	kaiHN
楷	kaiI
凯	kaiJ
铠	kaiJB
锴	kaiJC
锎	kaiJD
凱	kaiJM
鍇	kaiJN
鎧	kaiJO
鐦	kaiJP
鎎	kaiJQ
勓	kaiLM
桛	kaIM
開	kaiMM
闿	kaiMN
闓	kaiMO
嘅	kaiOM
欯	kaiQM
欬	kaiQN
暟	kaiRM
嵦	kaiSM
垲	kaiT
塏	kaiTM
蒈	kaiU
慨	kaiX
恺	kaiXB
忾	kaiXC
愷	kaiXM
愒	kaiXN
鯌	kaiYM
鉲	kaJM
裃	kaKM
卡	kaL
胩	kaLB
扻	kanAM
衎	kanCM
輡	kanCN
轗	kanCO
刊	kanD
鬫	kanDM
戡	kanG
抗	kangA
扛	kangAB
摃	kangAM
漮	kangEM
匟	kangFM
邟	kangFN
康	kangG
炕	kangH
穅	kangHM
槺	kangIM
钪	kangJ
鈧	kangJM
鏮	kangJN
糠	kangM
闶	kangMB
閌	kangMM
粇	kangMN
嫝	kangNM
砊	kangPM
犺	kangQM
嵻	kangSM
躿	kangSN
亢	kangT
伉	kangV
囥	kangWM
慷	kangX
忼	kangXM
鱇	kangYM
貇	kangZM
槛	kanI
檻	kanIM
栞	kanIN
凵	kanK
勘	kanL
龛	kanLB
龕	kanLM
竷	kanLN
看	kanM
瞰	kanMB
阚	kanMC
闞	kanMM
冚	kanMN
矙	kanMO
砍	kanP
丬	kanPB
磡	kanPM
欿	kanQM
歁	kanQN
嵌	kanS
崁	kanSM
嵁	kanSN
堪	kanT
坎	kanTB
埳	kanTM
墈	kanTN
莰	kanU
侃	kanV
偘	kanVM
惂	kanXM
顑	kanYM
貇	kanZM
咖	kaO
拷	kaoA
喀	kaOB
咯	kaOC
咔	kaOD
洘	kaoEM
靠	kaoF
髛	kaoGM
烤	kaoH
丂	kaoHM
焅	kaoHN
熇	kaoHO
稾	kaoHP
栲	kaoI
铐	kaoJ
銬	kaoJM
考	kaoL
犒	kaoN
尻	kaoP
嵪	kaoSM
薧	kaoUM
佧	kaoV
攷	kaoWM
鲓	kaoYM
鮳	kaoYN
垰	kaTM
佧	kaV
鰿	kaYM
揢	keAM
搕	keAN
客	keB
疴	keBB
痾	keBM
轲	keC
蝌	keCB
蚵	keCC
軻	keCM
尅	keCN
刻	keD
剋	keDM
渴	keE
溘	keEB
渇	keEM
濭	keEN
缂	keF
緙	keFM
匼	keFN
髁	keG
科	keH
稞	keHB
炣	keHM
棵	keI
柯	keIB
尅	keiCM
剋	keiDM
勀	keiLM
榼	keIM
樖	keIN
頢	keiYM
钶	keJ
锞	keJB
鈳	keJM
鉿	keJN
錒	keJO
錁	keJP
袔	keKM
龕	keLM
勀	keLN
勊	keLO
瞌	keM
骒	keMB
騾	keMM
騍	keMN
閜	keMO
毼	keMP
掯	kenAM
龈	kenC
齦	kenCM
龂	kenCN
齗	kenCO
挳	kengAM
揁	kengAN
摼	kengAO
阬	kengFM
铿	kengJ
鏗	kengJM
銵	kengJN
鍞	kengJO
脛	kengLM
劥	kengLN
妔	kengNM
牼	kengNN
吭	kengO
硁	kengPM
殸	kengPN
硜	kengPO
硻	kengPP
坑	kengT
坈	kengTM
誙	kengYM
鱠	kengYN
錹	kenJM
裉	kenK
褃	kenKM
肯	kenL
肎	kenLM
肻	kenLN
牱	keNM
娔	keNN
啃	kenO
犐	keNOL
硍	kenPM
豤	kenSM
垦	kenT
墾	kenTM
珢	kenWM
恳	kenX
懇	kenXM
窛	kenXN
可	keO
咳	keOB
嗑	keOC
磕	keP
殼	kePM
牁	kePN
砢	kePO
殻	kePP
硞	kePQ
磆	kePR
碦	kePS
礊	kePT
礚	kePU
氪	keQ
欬	keQM
歁	keQN
醘	keQO
克	keS
壳	keSB
岢	keSC
峇	keSM
嵑	keSN
嵙	keSO
嶱	keSP
坷	keT
堁	keTM
苛	keU
萪	keUM
薖	keUN
珂	keW
敤	keWM
恪	keX
窠	keXB
愾	keXM
悈	keXN
衉	keXO
愘	keXP
愙	keXQ
窼	keXR
课	keY
颗	keYB
颏	keYC
課	keYM
顆	keYN
頦	keYO
翗	keYP
趷	keZM
控	kongA
涳	kongEM
鞚	kongGM
椌	kongIM
錓	kongJM
箜	kongK
鵼	kongNM
矼	kongPM
硿	kongPN
崆	kongS
躻	kongSM
埪	kongTM
倥	kongV
空	kongX
恐	kongXB
悾	kongXM
窾	kongXN
羫	kongYM
孔	kongZ
扣	kouA
抠	kouAB
摳	kouAM
寇	kouB
宼	kouBM
剾	kouDM
滱	kouEM
彄	kouGM
釦	kouJM
筘	kouK
簆	kouKM
劶	kouLM
竘	kouLN
眍	kouM
瞘	kouMM
眗	kouMN
冦	kouMO
瞉	kouMP
鷇	kouNM
口	kouO
叩	kouOB
蔻	kouU
芤	kouUB
蔲	kouUM
敂	kouWM
怐	kouXM
艐	kouZM
挎	kuaA
夸	kuaD
絓	kuaFM
骻	kuaGM
擓	kuaiAM
浍	kuaiCM
巜	kuaiE
澮	kuaiEM
郐	kuaiF
鄶	kuaiFM
旝	kuaiFN
廥	kuaiGM
筷	kuaiK
凷	kuaiKM
脍	kuaiL
膾	kuaiLM
楇	kuaIM
駃	kuaiMM
糩	kuaiMN
哙	kuaiO
噲	kuaiOM
狯	kuaiQ
獪	kuaiQM
欳	kuaiQN
會	kuaiRM
块	kuaiT
塊	kuaiTM
圦	kuaiTN
墤	kuaiTO
蒯	kuaiU
蕢	kuaiUM
会	kuaiV
侩	kuaiVB
儈	kuaiVM
璯	kuaiWM
快	kuaiX
鲙	kuaiYM
鱠	kuaiYN
舿	kuaiZM
錁	kuaJM
銙	kuaJN
胯	kuaL
扝	kuAM
捁	kuAN
宽	kuanB
寬	kuanBM
寛	kuanBN
髋	kuanG
抂	kuangAM
况	kuangB
贶	kuangBB
貺	kuangBM
卝	kuangBN
軖	kuangCM
軠	kuangCN
軦	kuangCO
軭	kuangCP
夼	kuangD
剋	kuangDM
況	kuangEM
洭	kuangEN
匡	kuangF
邝	kuangFB
纩	kuangFC
鄺	kuangFM
纊	kuangFN
邼	kuangFO
匩	kuangFP
絋	kuangFQ
絖	kuangFR
黋	kuangHM
爌	kuangHN
穬	kuangHO
框	kuangI
鉱	kuangJM
鋛	kuangJN
鑛	kuangJO
筐	kuangK
筺	kuangKM
丱	kuangLM
劻	kuangLN
眶	kuangM
髖	kuanGML
眖	kuangMM
矌	kuangMN
鵟	kuangNM
哐	kuangO
矿	kuangP
礦	kuangPM
砿	kuangPN
硄	kuangPO
狂	kuangQ
狅	kuangQM
旷	kuangR
曠	kuangRM
昿	kuangRN
岲	kuangSM
圹	kuangT
壙	kuangTM
儣	kuangVM
忹	kuangXM
恇	kuangXN
懭	kuangXO
懬	kuangXP
诳	kuangY
诓	kuangYB
誆	kuangYM
誑	kuangYN
梡	kuanIM
鑧	kuanJM
臗	kuanLM
姱	kuaNM
款	kuanQ
欵	kuanQM
歀	kuanQN
窽	kuanXM
窾	kuanXN
迋	kuanZM
搰	kuAO
咵	kuaOM
晇	kuaRM
垮	kuaT
侉	kuaV
恗	kuaXM
誇	kuaYM
跨	kuaZ
趶	kuaZM
舿	kuaZN
躨	kuaZO
瘔	kuBM
刳	kuD
绔	kuF
絝	kuFM
郀	kuFN
库	kuG
骷	kuGB
庫	kuGM
廤	kuGN
秙	kuHM
焅	kuHN
枯	kuI
揆	kuiA
勹	kuiB
蝰	kuiC
奎	kuiD
刲	kuiDM
殨	kuiDN
溃	kuiE
潰	kuiEM
匮	kuiF
聩	kuiFB
隗	kuiFC
匱	kuiFM
聵	kuiFN
鄈	kuiFO
聭	kuiFP
聧	kuiFQ
魁	kuiG
戣	kuiGM
亏	kuiH
虧	kuiHM
煃	kuiHN
楏	kuiIM
楑	kuiIN
樻	kuiIO
櫆	kuiIP
卼	kuiJM
鍷	kuiJN
鍨	kuiJO
鐀	kuiJP
篑	kuiK
簣	kuiKM
籄	kuiKN
胿	kuiLM
膭	kuiLN
盔	kuiM
睽	kuiMB
桍	kuIML
骙	kuiMM
瞆	kuiMN
瞶	kuiMO
騤	kuiMP
闚	kuiMQ
楛	kuIN
媿	kuiNM
嬇	kuiNN
犪	kuiNO
喹	kuiO
喟	kuiOB
嘳	kuiOM
磈	kuiPM
欳	kuiQM
暌	kuiR
晆	kuiRM
馈	kuiS
馗	kuiSB
岿	kuiSC
饋	kuiSM
巋	kuiSN
餽	kuiSO
巙	kuiSP
葵	kuiU
蒉	kuiUB
蕢	kuiUM
藈	kuiUN
蘷	kuiUO
蘬	kuiUP
虁	kuiUQ
傀	kuiV
愧	kuiX
窥	kuiXB
愦	kuiXC
悝	kuiXD
窺	kuiXM
憒	kuiXN
鮭	kuiYM
尯	kuiYN
頄	kuiYO
頍	kuiYP
頯	kuiYQ
謉	kuiYR
顝	kuiYS
逵	kuiZ
夔	kuiZB
跬	kuiZC
歸	kuiZM
跍	kuiZN
蹞	kuiZO
躨	kuiZP
裤	kuK
褲	kuKM
袴	kuKN
朏	kuLM
胐	kuLN
捆	kunA
髡	kunB
髠	kunBM
髨	kunBN
蜫	kunCM
涃	kunEM
潉	kunEN
綑	kunFM
稇	kunHM
焜	kunHN
稛	kunHO
熴	kunHP
梱	kunIM
锟	kunJ
錕	kunJM
裈	kunKM
裍	kunKN
裩	kunKO
褌	kunKP
臗	kunLM
阃	kunM
閫	kunMM
睏	kunMN
閸	kunMO
騉	kunMP
婫	kunNM
鹍	kunNN
鵾	kunNO
鶤	kunNP
硱	kunPM
醌	kunQ
猑	kunQM
昆	kunR
晜	kunRM
壸	kunSM
崐	kunSN
崑	kunSO
祵	kunSP
壼	kunSQ
豤	kunSR
坤	kunT
堒	kunTM
堃	kunTN
菎	kunUM
困	kunW
琨	kunWB
瑻	kunWM
悃	kunX
鲲	kunY
鯤	kunYM
鰥	kunYN
鱇	kunYO
哭	kuO
括	kuoA
扩	kuoAB
擴	kuoAM
拡	kuoAN
挄	kuoAO
喾	kuOB
髺	kuoBM
鬠	kuoBN
蛞	kuoC
漷	kuoEM
濶	kuoEN
廓	kuoG
鞟	kuoGM
鞹	kuoGN
秮	kuoHM
秳	kuoHN
铦	kuoJM
銛	kuoJN
銽	kuoJO
筈	kuoKM
阔	kuoM
嚳	kuOML
闊	kuoMM
噋	kuoOM
霩	kuoRM
葀	kuoUM
萿	kuoUN
韕	kuoWM
懖	kuoXM
顑	kuoYM
适	kuoZ
矻	kuPM
硞	kuPN
酷	kuQ
狜	kuQM
堀	kuT
苦	kuU
俈	kuVM
圐	kuWM
窟	kuX
窋	kuXM
鮬	kuYM
跍	kuZM
拉	laA
揦	laAM
搚	laAN
揧	laAO
擸	laAP
攋	laAQ
瘌	laB
癩	laBM
鬎	laBN
蜡	laC
蠟	laCM
蝋	laCN
蝲	laCO
剌	laD
溂	laEM
鞡	laGM
爉	laHM
攋	laiAM
赖	laiB
癞	laiBB
赉	laiBC
賴	laiBM
賚	laiBN
賫	laiBO
癘	laiBP
癩	laiBQ
徕	laiC
徠	laiCM
濑	laiE
涞	laiEB
淶	laiEM
瀨	laiEN
瀬	laiEO
郲	laiFM
庲	laiGM
来	laiI
梾	laiIM
棶	laiIN
櫴	laiIO
铼	laiJ
錸	laiJM
籁	laiK
籟	laiKM
筙	laiKN
箂	laiKO
襰	laiKP
勑	laiLM
睐	laiM
柆	laIML
睞	laiMM
騋	laiMN
麳	laiMO
楋	laIN
娕	laiNM
婡	laiNN
鵣	laiNO
鶆	laiNP
櫴	laIO
唻	laiOM
猍	laiQM
崃	laiS
崍	laiSM
莱	laiU
萊	laiUM
藾	laiUN
來	laiVM
俫	laiVN
倈	laiVO
琜	laiWM
誺	laiYM
頼	laiYN
顂	laiYO
鯠	laiYP
顟	laiYQ
镴	laJM
鑞	laJN
腊	laL
臘	laLM
臈	laLN
拦	lanA
揽	lanAB
攔	lanAM
攬	lanAN
擥	lanAO
兰	lanB
厱	lanCM
滥	lanE
澜	lanEB
漤	lanEC
濫	lanEM
瀾	lanEN
浨	lanEO
灆	lanEP
灡	lanEQ
灠	lanER
缆	lanF
纜	lanFM
繿	lanFN
螂	langC
蜋	langCM
浪	langE
郎	langF
郞	langFM
郒	langFN
廊	langG
稂	langH
烺	langHM
榔	langI
桹	langIM
樃	langIN
锒	langJ
鋃	langJM
鎯	langJN
筤	langKM
朗	langL
勆	langLM
朖	langLN
朤	langLO
阆	langM
韊	lanGML
閬	langMM
駺	langMN
嫏	langNM
啷	langO
哴	langOM
硠	langPM
狼	langQ
欴	langQM
崀	langSM
躴	langSN
埌	langTM
塱	langTN
莨	langU
蒗	langUB
蓈	langUM
蓢	langUN
琅	langW
瑯	langWM
斏	langWN
圙	langWO
誏	langYM
羮	langYN
烂	lanH
爛	lanHM
燗	lanHN
燷	lanHO
燣	lanHP
爁	lanHQ
爤	lanHR
爦	lanHS
栏	lanI
榄	lanIB
欄	lanIM
欖	lanIN
欗	lanIO
览	lanJ
镧	lanJB
覽	lanJM
鑭	lanJN
覧	lanJO
幱	lanJP
钄	lanJR
篮	lanK
褴	lanKB
籃	lanKM
襤	lanKN
襕	lanKO
襴	lanKP
籣	lanKQ
襽	lanKR
阑	lanM
闌	lanMM
糷	lanMN
婪	lanN
嬾	lanNM
孄	lanNN
孏	lanNO
嚂	lanOM
囒	lanON
囕	lanOO
醂	lanQM
暕	lanRM
岚	lanS
罱	lanSB
嵐	lanSM
坔	lanTM
壈	lanTN
壏	lanTO
蓝	lanU
藍	lanUM
蘭	lanUN
葻	lanUO
蘫	lanUP
儖	lanVM
斓	lanW
斕	lanWM
璼	lanWN
瓓	lanWO
懒	lanX
懶	lanXM
惏	lanXN
懢	lanXO
谰	lanY
讕	lanYM
諫	lanYN
譋	lanYO
顲	lanYP
踚	lanZM
躝	lanZN
啦	laO
捞	laoA
撈	laoAM
喇	laOB
痨	laoBL
癆	laoBM
蛯	laoCM
蟧	laoCN
轑	laoCO
潦	laoE
涝	laoEB
澇	laoEM
浶	laoEN
络	laoF
絡	laoFM
髝	laoGM
烙	laoH
栳	laoI
橑	laoIM
橯	laoIN
铑	laoJ
铹	laoJB
銠	laoJM
鐒	laoJN
簩	laoKM
老	laoL
劳	laoLB
耢	laoLC
勞	laoLM
耮	laoLN
耂	laoLO
労	laoLP
朥	laoLQ
嚹	laOM
閖	laoMM
粩	laoMN
牢	laoN
姥	laoNB
嫪	laoNM
唠	laoO
嘮	laoOM
咾	laoON
哰	laoOO
嗠	laoOP
硓	laoPM
磱	laoPN
酪	laoQ
醪	laoQB
狫	laoQM
崂	laoS
嶗	laoSM
躼	laoSN
軂	laoSO
落	laoU
荖	laoUM
佬	laoV
僗	laoVM
珯	laoWM
忉	laoX
恅	laoXM
窂	laoXN
憦	laoXO
憥	laoXP
鮱	laoYM
顟	laoYN
鱩	laoYO
邋	laoZ
砬	laP
磖	laPM
旯	laR
垃	laT
落	laU
菈	laUM
藞	laUN
瓎	laWM
辣	laX
辢	laXM
翋	laYM
誙	laYN
鯻	laYO
邋	laZ
扐	leAM
泐	leE
氻	leEM
阞	leFM
擂	leiA
攂	leiAM
瘣	leiBM
癗	leiBN
蠝	leiCM
轠	leiCN
泪	leiE
淚	leiEM
洡	leiEN
涙	leiEO
灅	leiEP
累	leiF
缧	leiFB
縲	leiFM
郲	leiFN
絫	leiFO
罍	leiFP
纍	leiFQ
纇	leiFR
纝	leiFS
檑	leiI
樏	leiIM
櫑	leiIN
櫐	leiIO
欙	leiIP
镭	leiJ
鐳	leiJM
銇	leiJN
錑	leiJO
鑘	leiJP
鑸	leiJQ
勒	leiL
肋	leiLB
耒	leiLC
羸	leiLD
类	leiM
樂	leIML
矋	leiMM
嫘	leiN
楽	leINL
鸓	leiNM
嘞	leiO
磊	leiP
磥	leiPM
礌	leiPN
礧	leiPO
礨	leiPP
酹	leiQ
雷	leiR
靁	leiRM
厽	leiSM
祱	leiSN
禷	leiSO
鼺	leiSP
垒	leiT
壘	leiTM
塁	leiTN
畾	leiTO
壨	leiTP
蕾	leiU
蔂	leiUM
蕌	leiUN
藟	leiUO
蘲	leiUP
蘽	leiUQ
蘱	leiUR
虆	leiUS
儡	leiV
傫	leiVM
儽	leiVN
瓃	leiWM
诔	leiY
類	leiYM
誄	leiYN
頛	leiYO
頪	leiYP
讄	leiYQ
邏	leiZM
竻	leKM
簕	leKN
勒	leL
肋	leLB
冷	lengB
稜	lengHM
棱	lengI
楞	lengIB
睖	lengMM
唥	lengOM
碐	lengPM
崚	lengSM
塄	lengT
堎	lengTM
薐	lengUM
倰	lengVM
愣	lengX
踜	lengZM
牞	leNM
叻	leO
乐	leP
砳	lePM
饹	leSM
餎	leSN
艻	leUM
了	leV
仂	leVB
玏	leWM
忇	leXM
鳓	leY
鰳	leYM
鱳	leYN
逨	leZM
扐	liAM
扚	liAN
摙	lianAM
鬑	lianBM
蠊	lianC
螊	lianCM
殓	lianD
奁	lianDB
奩	lianDM
殮	lianDN
劆	lianDO
涟	lianE
潋	lianEB
濂	lianEC
漣	lianEM
瀲	lianEN
浰	lianEO
湅	lianEP
溓	lianEQ
澰	lianER
濓	lianES
瀮	lianET
联	lianF
练	lianFB
練	lianFM
聯	lianFN
匲	lianFO
聨	lianFP
聫	lianFQ
匳	lianFR
聮	lianFS
縺	lianFT
鄻	lianFU
纞	lianFV
廉	lianG
掚	liangAM
凉	liangB
辆	liangC
輛	liangCM
辌	liangCN
輌	liangCO
蜋	liangCP
蜽	liangCQ
輬	liangCR
涼	liangEM
湸	liangEN
緉	liangFM
綡	liangFN
良	liangG
魉	liangGB
魎	liangGM
两	liangH
兩	liangHM
両	liangHN
梁	liangI
椋	liangIB
樑	liangIM
锒	liangJ
鍄	liangJM
裲	liangKM
簗	liangKN
量	liangL
脼	liangLM
粮	liangM
粱	liangMB
糧	liangMM
駺	liangMN
唡	liangOM
哴	liangON
啢	liangOO
喨	liangOP
靓	liangQ
靚	liangQM
晾	liangR
亮	liangT
墚	liangTB
莨	liangU
俩	liangV
倆	liangVM
俍	liangVN
倞	liangVO
悢	liangXM
谅	liangY
諒	liangYM
颣	liangYN
踉	liangZ
炼	lianH
煉	lianHM
熑	lianHN
稴	lianHO
燫	lianHP
楝	lianI
梿	lianIM
槤	lianIN
槏	lianIO
櫣	lianIP
檶	lianIQ
链	lianJ
帘	lianJB
镰	lianJC
鏈	lianJM
鐮	lianJN
覝	lianJO
錬	lianJP
鍊	lianJQ
鎌	lianJR
裢	lianK
裣	lianKB
簾	lianKM
褳	lianKN
襝	lianKO
籢	lianKP
籨	lianKQ
脸	lianL
臁	lianLB
臉	lianLM
孌	lianNM
媡	lianNN
嫾	lianNO
嬚	lianNP
嗹	lianOM
噒	lianON
磏	lianPM
歛	lianQM
醶	lianQN
堜	lianTM
亷	lianTN
莲	lianU
蔹	lianUB
蓮	lianUM
薟	lianUN
蘞	lianUO
萰	lianUP
薕	lianUQ
蘝	lianUR
僆	lianVM
敛	lianW
琏	lianWB
斂	lianWM
璉	lianWN
瑓	lianWO
恋	lianX
怜	lianXB
憐	lianXM
戀	lianXN
慩	lianXO
鲢	lianY
鰱	lianYM
翴	lianYN
謰	lianYO
羷	lianYP
鰊	lianYQ
连	lianZ
連	lianZM
赲	lianZN
蹥	lianZO
搮	liAO
撩	liaoA
撂	liaoAB
摎	liaoAM
疗	liaoB
寥	liaoBB
寮	liaoBC
療	liaoBM
尦	liaoBN
賿	liaoBO
蟟	liaoCM
蟧	liaoCN
镽	liaoCO
轑	liaoCP
料	liaoD
潦	liaoE
漻	liaoEM
聊	liaoF
缭	liaoFB
繆	liaoFM
繚	liaoFN
鄝	liaoFO
飂	liaoFP
飉	liaoFQ
廖	liaoG
豂	liaoGM
廫	liaoGN
髎	liaoGO
燎	liaoH
炓	liaoHM
爎	liaoHN
爒	liaoHO
樛	liaoIM
橑	liaoIN
镣	liaoJ
钌	liaoJB
鐐	liaoJM
釕	liaoJN
簝	liaoKM
膋	liaoLM
膫	liaoLN
瞭	liaoMM
鹩	liaoN
鷯	liaoNM
嫽	liaoNN
嘹	liaoO
屪	liaoPM
獠	liaoQ
暸	liaoRM
嵺	liaoSM
嶚	liaoSN
嶛	liaoSO
蓼	liaoU
藔	liaoUM
了	liaoV
僚	liaoVB
敹	liaoWM
璙	liaoWN
窌	liaoXM
尞	liaoXN
憀	liaoXO
憭	liaoXP
窷	liaoXQ
竂	liaoXR
尥	liaoY
辽	liaoZ
遼	liaoZM
蹽	liaoZN
躝	liaoZO
擽	liAP
攊	liAQ
攦	liAR
攭	liAS
俩	liaV
倆	liaVM
慺	liaXM
痢	liB
疠	liBB
疬	liBC
癘	liBM
癧	liBN
凓	liBO
鬁	liBP
皪	liBQ
历	liC
厉	liCB
厘	liCC
蠡	liCD
蛎	liCE
蜊	liCF
轹	liCG
厲	liCM
蠣	liCN
轢	liCO
蚸	liCP
厤	liCQ
蛠	liCR
厯	liCS
蜧	liCT
蝷	liCU
蟍	liCV
蠇	liCW
蟸	liCX
蠫	liCY
轣	liCZ
利	liD
刂	liDB
刕	liDM
剓	liDN
剺	liDO
豊	liDP
劙	liDQ
黎	liE
捩	lieA
挒	lieAM
挘	lieAN
擸	lieAO
漓	liEB
鬣	lieBB
冽	lieBL
鬛	lieBM
沥	liEC
蛚	lieCM
巤	lieCN
列	lieD
溧	liEDL
洌	lieE
澧	liEEL
浖	lieEM
聗	lieFM
綟	lieFN
颲	lieFO
烈	lieH
烮	lieHM
煭	lieHN
燤	lieHO
爄	lieHP
爉	lieHQ
栵	lieIM
棙	lieIN
櫑	lieIO
裂	lieK
劣	lieL
劦	lieLM
劽	lieLN
脟	lieLO
瀝	liEM
毟	lieMM
睙	lieMN
沴	liEN
姴	lieNM
鴷	lieNN
犣	lieNO
咧	lieO
沵	liEOL
哷	lieOM
浬	liEP
猎	lieQ
浰	liEQL
獵	lieQM
猟	lieQN
獦	lieQO
涖	liER
漦	liES
巁	lieSM
埒	lieT
濿	liETL
埓	lieTM
灕	liEU
茢	lieUM
儠	lieVM
忚	lieXM
鮤	lieYM
鱲	lieYN
趔	lieZ
躐	lieZB
迾	lieZM
躘	lieZN
郦	liF
缡	liFB
縭	liFM
酈	liFN
綟	liFO
纅	liFP
纚	liFQ
鬲	liG
廲	liGM
瓥	liGN
丽	liH
戾	liHB
黧	liHC
秝	liHM
爄	liHN
爏	liHO
穲	liHP
李	liI
梨	liIB
栗	liIC
栎	liID
枥	liIE
櫟	liIM
櫪	liIN
朸	liIO
杝	liIP
柂	liIQ
栃	liIR
栵	liIS
栛	liIT
梸	liIU
棙	liIV
棃	liIW
樆	liIX
檪	liIY
欐	liIYL
櫔	liIZ
欚	liIZL
锂	liJ
鋰	liJM
鎘	liJN
鉝	liJO
銐	liJP
鋫	liJQ
錅	liJR
鏫	liJS
觻	liJT
鑗	liJU
篱	liK
笠	liKB
篥	liKC
裏	liKM
籬	liKN
裡	liKO
筣	liKP
褵	liKQ
里	liL
力	liLB
立	liLC
隶	liLD
励	liLE
膦	liLF
勵	liLM
隸	liLN
麗	liLO
脷	liLP
竰	liLQ
隷	liLR
釐	liLS
麜	liLT
粒	liM
骊	liMB
粝	liMC
糲	liMM
驪	liMN
睙	liMO
睝	liMP
粴	liMQ
盠	liMR
糎	liMS
盭	liMT
犁	liN
拎	linA
撛	linAM
凛	linB
赁	linBB
鹂	liNBL
賃	linBM
凜	linBN
痳	linBO
癝	linBP
癛	linBQ
辚	linC
嫠	liNCL
臨	linCM
轔	linCN
轥	linCO
娌	liND
淋	linE
潾	linEM
澟	linEN
瀶	linEO
邻	linF
鄰	linFM
阾	linFN
隣	linFO
綝	linFP
繗	linFQ
廪	linG
掕	lingAM
凌	lingB
皊	lingBM
龄	lingC
蛉	lingCB
齡	lingCM
彾	lingCN
衑	lingCO
軨	lingCP
輘	lingCQ
齢	lingCR
刢	lingDM
泠	lingE
淩	lingEM
澪	lingEN
陵	lingF
绫	lingFB
聆	lingFC
酃	lingFD
綾	lingFM
紷	lingFN
灵	lingH
炩	lingHM
秢	lingHN
稜	lingHO
燯	lingHP
爧	lingHQ
棱	lingI
棂	lingIB
柃	lingIC
欞	lingIM
櫺	lingIN
铃	lingJ
鈴	lingJM
錂	lingJN
袊	lingKM
笭	lingKN
裬	lingKO
朎	lingLM
竛	lingLN
鹷	lingLO
麢	lingLP
龗	lingLQ
廩	linGM
閝	lingMM
駖	lingMN
姈	lingNM
鸰	lingNN
婈	lingNO
鴒	lingNP
孁	lingNQ
另	lingO
呤	lingOB
砱	lingPM
狑	lingQM
醽	lingQN
零	lingR
靈	lingRM
昤	lingRN
霊	lingRO
霗	lingRP
霝	lingRQ
霛	lingRR
岭	lingS
嶺	lingSM
岺	lingSN
崚	lingSO
祾	lingSP
坽	lingTM
菱	lingU
苓	lingUB
羐	lingUM
蓤	lingUN
蔆	lingUO
蕶	lingUP
蘦	lingUQ
令	lingV
伶	lingVB
倰	lingVM
玲	lingW
囹	lingWB
瓴	lingWC
琌	lingWM
领	lingY
翎	lingYB
羚	lingYC
鲮	lingYD
領	lingYM
鯪	lingYN
詅	lingYO
魿	lingYP
〇	lingZ
夌	lingZM
舲	lingZN
跉	lingZO
蹸	lingZP
焛	linHM
燐	linHN
林	linI
檩	linIB
檁	linIM
橉	linIN
斴	linJM
鏻	linJN
箖	linKM
临	linL
麟	linLB
膦	linLC
麐	linLM
粼	linM
瞵	linMB
鸝	liNML
冧	linMM
粦	linMN
閵	linMO
驎	linMP
娳	liNN
吝	linO
啉	linOB
婯	liNOL
磷	linP
犂	liNPL
碄	linPM
鳨	liNQ
獜	linQM
霖	linR
犛	liNRL
晽	linRM
暽	linRN
嶙	linS
鴗	liNSL
厸	linSM
崊	linSN
犡	liNT
疄	linTM
壣	linTN
蔺	linU
鵹	liNUL
藺	linUM
菻	linUN
鷅	liNV
倆	linVM
亃	linVN
僯	linVO
琳	linW
孋	liNWL
璘	linWM
甐	linWN
懔	linX
懍	linXM
恡	linXN
悋	linXO
惏	linXP
鳞	linY
鱗	linYM
翷	linYN
顲	linYO
遴	linZ
躏	linZB
躪	linZM
蹸	linZN
躙	linZO
哩	liO
吏	liOB
唳	liOC
呖	liOD
喱	liOE
嚦	liOM
唎	liON
嚟	liOO
囄	liOP
囇	liOQ
砾	liP
砺	liPB
礫	liPM
礪	liPN
砅	liPO
磿	liPP
礰	liPQ
狸	liQ
猁	liQB
醴	liQC
醨	liQM
雳	liR
靂	liRM
暦	liRN
曆	liRO
曞	liRP
靋	liRQ
礼	liS
罹	liSB
禮	liSM
屴	liSN
岦	liSO
峛	liSP
峢	liSQ
峲	liSR
巁	liSS
禲	liST
离	liT
坜	liTB
壢	liTM
塛	liTN
莉	liU
摎	liuAM
瘤	liuB
荔	liUBL
癅	liuBM
藜	liUC
蟉	liuCM
刘	liuD
莅	liUDL
劉	liuDM
流	liuE
溜	liuEB
浏	liuEC
蓠	liUEL
瀏	liuEM
漻	liuEN
澑	liuEO
陆	liuF
绺	liuFB
旒	liuFC
苈	liUFL
陸	liuFM
綹	liuFN
斿	liuFO
旈	liuFP
飗	liuFQ
飀	liuFR
飂	liuFS
飅	liuFT
廇	liuGM
鬸	liuGN
熘	liuH
熮	liuHM
柳	liuI
榴	liuIB
栁	liuIM
桞	liuIN
桺	liuIO
橊	liuIP
橮	liuIQ
鎏	liuJ
镏	liuJB
锍	liuJC
鋶	liuJM
鎦	liuJN
镠	liuJO
鏐	liuJP
鐂	liuJQ
裗	liuKM
麍	liuLM
骝	liuM
蒞	liUML
騮	liuMM
駠	liuMN
駵	liuMO
驑	liuMP
鹨	liuN
藶	liUNL
鷚	liuNM
媹	liuNN
鹠	liuNO
嬼	liuNP
鶹	liuNQ
蘺	liUO
嚠	liuOM
硫	liuP
碌	liuPB
苙	liUPL
磂	liuPM
磟	liuPN
茘	liUQ
荲	liUR
霤	liuRM
馏	liuS
菞	liUSL
餾	liuSM
嵧	liuSN
罶	liuSO
六	liuT
留	liuTB
蒚	liUTL
畄	liuTM
畱	liuTN
塯	liuTO
疁	liuTP
羀	liuTQ
蔾	liUU
蒥	liuUM
蓅	liuUN
藰	liuUO
琉	liuW
珋	liuWM
瑠	liuWN
瑬	liuWO
璢	liuWP
窌	liuXM
懰	liuXN
翏	liuYM
鰡	liuYN
遛	liuZ
蹓	liuZM
蹘	liuZN
雡	liuZO
例	liV
俐	liVB
俪	liVC
俚	liVD
傈	liVE
儷	liVM
儮	liVN
理	liW
璃	liWB
珕	liWM
琍	liWN
瓼	liWO
甅	liWP
瑮	liWQ
瓈	liWR
瓅	liWS
斄	liWT
瓑	liWU
悧	liXM
悡	liXN
悷	liXO
慄	liXP
鲤	liY
詈	liYB
鲡	liYC
鳢	liYD
鯉	liYM
鱧	liYN
鱺	liYO
叓	liYP
叕	liYQ
謧	liYR
鯏	liYS
鯬	liYT
讈	liYU
鱱	liYV
逦	liZ
跞	liZB
貍	liZM
歷	liZN
離	liZO
邐	liZP
躒	liZQ
迣	liZR
赲	liZS
艃	liZT
艆	liZU
孷	liZV
歴	liZW
邌	liZX
拢	longA
攏	longAM
癃	longB
贚	longBM
衖	longCM
徿	longCN
蠬	longCO
蠪	longCP
泷	longE
瀧	longEM
湰	longEN
滝	longEO
漋	longEP
隆	longF
聋	longFB
陇	longFC
隴	longFM
聾	longFN
弄	longG
谾	longGM
豅	longGN
爖	longHM
栊	longI
櫳	longIM
梇	longIN
槞	longIO
鏧	longJM
鑨	longJN
笼	longK
籠	longKM
篢	longKN
篭	longKO
襱	longKP
龙	longL
胧	longLB
龍	longLM
朧	longLN
竜	longLO
龒	longLP
龓	longLQ
眬	longMM
矓	longMN
驡	longMO
鸗	longNM
咙	longO
嚨	longOM
哢	longON
砻	longP
礱	longPM
硦	longPN
礲	longPO
昽	longRM
霳	longRN
曨	longRO
靇	longRP
屸	longSM
嶐	longSN
巃	longSO
巄	longSP
垄	longT
垅	longTB
壟	longTM
壠	longTN
茏	longU
蘢	longUM
儱	longVM
珑	longW
瓏	longWM
窿	longX
竉	longXM
尨	longYM
孿	longZM
躘	longZN
搂	louA
摟	louAM
瘘	louB
瘺	louBM
寠	louBN
瘻	louBO
蝼	louC
螻	louCM
漏	louE
溇	louEM
漊	louEN
陋	louF
髅	louG
髏	louGM
廔	louGN
鞻	louGO
熡	louHM
楼	louI
樓	louIM
镂	louJ
鏤	louJM
篓	louK
簍	louKM
耧	louL
耬	louLM
瞜	louMM
娄	louN
婁	louNM
鷜	louNN
喽	louO
嘍	louOM
屚	louPM
露	louR
嵝	louS
嶁	louSM
軁	louSN
塿	louTM
蒌	louU
蔞	louUM
偻	louV
僂	louVM
甊	louWM
窶	louXM
慺	louXN
韷	louYM
謱	louYN
遱	louZM
艛	louZN
掳	luA
撸	luAB
擄	luAM
擼	luAN
挛	luanA
攣	luanAM
癴	luanBM
癵	luanBN
奱	luanDM
滦	luanE
灤	luanEM
灓	luanEN
栾	luanI
欒	luanIM
卵	luanJ
銮	luanJB
鑾	luanJM
釠	luanJN
覶	luanJO
脟	luanLM
鸾	luanN
娈	luanNB
孌	luanNM
鸞	luanNN
鵉	luanNO
脔	luanR
臠	luanRM
曫	luanRN
臡	luanRO
峦	luanS
巒	luanSM
羉	luanSN
薍	luanUM
虊	luanUN
乱	luanV
亂	luanVM
乿	luanVN
圝	luanWM
圞	luanWN
孪	luanZ
踉	luanZB
孿	luanZM
挔	luAO
摝	luAP
攎	luAQ
卢	luB
卤	luBB
赂	luBC
賂	luBM
辘	luC
辂	luCB
轳	luCC
輅	luCM
轆	luCN
轤	luCO
螰	luCP
蠦	luCQ
剹	luDM
泸	luE
掠	lueA
漉	luEB
潞	luEC
渌	luED
锊	lueJ
鋝	lueJM
濾	luEM
淥	luEN
瀘	luEO
淕	luEP
滷	luEQ
漊	luER
澛	luES
略	lueT
瀂	luETL
畧	lueTM
陆	luF
绿	luFB
陸	luFM
緑	luFN
罏	luFO
纑	luFP
庐	luG
戮	luGB
廬	luGM
廘	luGN
髗	luGO
炉	luH
虏	luHB
虜	luHM
爐	luHN
穭	luHO
稑	luHP
熝	luHQ
穋	luHR
穞	luHS
黸	luHT
橹	luI
栌	luIB
櫓	luIM
櫨	luIN
枦	luIO
椂	luIP
樐	luIQ
樚	luIR
镥	luJ
錄	luJM
鑥	luJN
鈩	luJO
錴	luJP
録	luJQ
鏀	luJR
鏕	luJS
鐪	luJT
鏴	luJU
觻	luJV
鑪	luJW
簏	luK
箓	luKM
簶	luKN
簵	luKO
簬	luKP
籚	luKQ
籙	luKR
鹿	luL
麓	luLB
胪	luLC
鹵	luLM
臚	luLN
勎	luLO
勠	luLP
膔	luLQ
膟	luLR
氇	luM
盧	luMM
氌	luMN
睩	luMO
盝	luMP
馿	luMQ
粶	luMR
騄	luMS
騼	luMT
矑	luMU
鹭	luN
抡	lunA
掄	lunAM
鸬	luNB
轮	lunC
輪	lunCM
蜦	lunCN
沦	lunE
淪	lunEM
溣	lunEN
纶	lunF
綸	lunFM
陯	lunFN
稐	lunHM
棆	lunIM
錀	lunJM
腀	lunLM
耣	lunLN
鷺	luNM
睔	lunMM
鸕	luNN
婨	lunNM
娽	luNO
鴼	luNP
碖	lunPM
磮	lunPN
鵱	luNQ
鵦	luNR
崘	lunSM
崙	lunSN
埨	lunTM
芲	lunUM
菕	lunUN
伦	lunV
仑	lunVB
侖	lunVM
倫	lunVN
囵	lunW
圇	lunWM
惀	lunXM
论	lunY
論	lunYM
鯩	lunYN
踚	lunZM
蹥	lunZN
噜	luO
捋	luoA
摞	luoAB
捰	luoAM
擽	luoAN
攊	luoAO
攎	luoAP
攞	luoAQ
攭	luoAR
瘰	luoB
皪	luoBM
癳	luoBN
螺	luoC
蠃	luoCB
寽	luoCM
蛒	luoCN
剆	luoDM
洛	luoE
漯	luoEB
泺	luoEC
濼	luoEM
洜	luoEN
渃	luoEO
络	luoF
絡	luoFM
纙	luoFN
烙	luoH
椤	luoI
欏	luoIM
欙	luoIN
锣	luoJ
镙	luoJB
鑼	luoJM
鏍	luoJN
覶	luoJO
覼	luoJP
裸	luoK
箩	luoKB
籮	luoKM
笿	luoKN
脶	luoL
腡	luoLM
臝	luoLN
骆	luoM
骡	luoMB
嚕	luOML
駱	luoMM
騾	luoMN
驘	luoMO
嚧	luON
犖	luoNM
鵅	luoNN
鸁	luoNO
咯	luoO
啰	luoOM
囉	luoON
囖	luoOO
硌	luoP
礫	luoPM
砢	luoPN
硦	luoPO
磱	luoPP
猡	luoQ
猓	luoQB
玀	luoQM
曪	luoRM
罗	luoS
羅	luoSM
峈	luoSN
躶	luoSO
饠	luoSP
落	luoU
萝	luoUB
荦	luoUC
蘿	luoUM
茖	luoUN
蓏	luoUO
倮	luoV
儸	luoVM
儽	luoVN
珞	luoW
詻	luoYM
頱	luoYN
鮥	luoYO
鱳	luoYP
逻	luoZ
雒	luoZB
跞	luoZC
邏	luoZM
躒	luoZN
雡	luoZO
碌	luP
硉	luPM
硵	luPN
磠	luPO
磟	luPP
醁	luQM
獹	luQN
露	luR
曥	luRM
禄	luS
祿	luSM
峍	luSN
垆	luT
六	luTB
壚	luTM
圥	luTN
坴	luTO
塷	luTP
塶	luTQ
芦	luU
蘆	luUM
菉	luUN
蓾	luUO
蔍	luUP
蕗	luUQ
虂	luUR
侓	luVM
僇	luVN
璐	luW
琭	luWM
璷	luWN
瓐	luWO
录	luX
彔	luXM
玈	luXN
鲁	luY
颅	luYB
鲈	luYC
魯	luYM
顱	luYN
鱸	luYO
甪	luYP
翏	luYQ
魲	luYR
謢	luYS
鯥	luYT
路	luZ
逯	luZB
舻	luZC
艫	luZM
迾	luZN
舮	luZO
趢	luZP
踛	luZQ
蹗	luZR
艣	luZS
艪	luZT
捋	lvA
捛	lvAM
挔	lvAN
寠	lvBM
瘻	lvBN
律	lvC
滤	lvE
掠	lveAB
寽	lveCM
稤	lveHM
锊	lveJB
鋝	lveJN
鋢	lveJO
濾	lvEM
略	lveTB
畧	lveTN
貗	lveZM
绿	lvF
旅	lvFB
缕	lvFC
綠	lvFM
縷	lvFN
郘	lvFO
絽	lvFP
緑	lvFQ
繂	lvFR
虑	lvH
稆	lvHB
穭	lvHM
焒	lvHN
爈	lvHO
榈	lvI
櫚	lvIM
櫨	lvIN
梠	lvIO
櫖	lvIP
铝	lvJ
鋁	lvJM
録	lvJN
鑢	lvJO
褛	lvK
簍	lvKM
褸	lvKN
箻	lvKO
膂	lvL
膢	lvLM
膟	lvLN
勴	lvLO
驴	lvM
闾	lvMB
驢	lvMM
閭	lvMN
氀	lvMO
瞜	lvMP
鷜	lvNM
吕	lvO
呂	lvOM
哷	lvON
履	lvP
屡	lvPB
屢	lvPM
氯	lvQ
膐	lvRM
祣	lvSM
嵂	lvSN
卛	lvSO
垏	lvTM
蔞	lvUM
葎	lvUN
藘	lvUO
侣	lvV
偻	lvVB
侶	lvVM
僂	lvVN
儢	lvVO
率	lvX
慮	lvXM
慺	lvXN
謱	lvYM
艣	lvZM
抹	maA
摩	maAB
痲	maBM
痳	maBN
鬕	maBO
蚂	maC
蟆	maCB
螞	maCM
蟇	maCN
溤	maEM
杩	maI
買	maiBM
賣	maiBN
脉	maiL
劢	maiLB
脈	maiLM
勱	maiLN
麦	maiM
榪	maIML
麥	maiMM
鷶	maiNM
唛	maiO
嘪	maiOM
霾	maiR
霡	maiRM
霢	maiRN
卖	maiS
売	maiSM
埋	maiT
荬	maiU
蕒	maiUM
薶	maiUN
买	maiV
佅	maiVM
衇	maiXM
迈	maiZ
邁	maiZM
鎷	maJM
马	maM
麻	maMB
骂	maMC
麽	maMD
馬	maMM
閁	maMN
睰	maMO
駡	maMP
妈	maN
摱	manAM
匁	manBM
鬗	manBN
鬘	manBO
蛮	manC
螨	manCB
蠻	manCM
蟎	manCN
蟃	manCO
满	manE
漫	manEB
滿	manEM
満	manEN
澫	manEO
澷	manEP
缦	manF
縵	manFM
鄤	manFN
絻	manFO
鞔	manG
痝	mangBM
蟒	mangC
厖	mangCM
蛖	mangCN
蠎	mangCO
漭	mangE
汒	mangEM
浝	mangEN
邙	mangF
庬	mangGM
杧	mangIM
杗	mangIN
铓	mangJM
釯	mangJN
鋩	mangJO
笀	mangKM
朚	mangLM
龒	mangLN
盲	mangM
盳	mangMM
駹	mangMN
牤	mangNM
娏	mangNN
牻	mangNO
吂	mangOM
哤	mangON
硭	mangP
硥	mangPM
狵	mangQM
氓	mangS
壾	mangSM
芒	mangU
茫	mangUB
莽	mangUC
莾	mangUM
茻	mangUN
蘉	mangUO
忙	mangX
恾	mangXM
尨	mangYM
熳	manH
樠	manIM
槾	manIN
幔	manJ
镘	manJB
鏝	manJM
鏋	manJN
襔	manKM
瞒	manM
媽	maNML
瞞	manMM
睌	manMN
矕	manMO
嬤	maNN
姏	manNM
娨	manNN
嫚	manNO
嫲	maNO
犘	maNP
屘	manPM
鷌	maNQ
獌	manQM
曼	manR
馒	manS
饅	manSM
埋	manT
墁	manTB
蔓	manU
蔄	manUM
蘰	manUN
僈	manVM
慢	manX
悗	manXM
慲	manXN
鳗	manY
谩	manYB
颟	manYC
謾	manYM
顢	manYN
鰻	manYO
吗	maO
嘛	maOB
髦	maoBB
贸	maoBL
貿	maoBM
皃	maoBN
髳	maoBO
蝥	maoC
蟊	maoCB
唛	maOCL
軞	maoCM
蝐	maoCN
泖	maoE
渵	maoEM
旄	maoF
鄚	maoFM
鄮	maoFN
緢	maoFO
戼	maoHM
秏	maoHN
枆	maoIM
柕	maoIN
楙	maoIO
帽	maoJ
卯	maoJB
锚	maoJC
铆	maoJD
鉚	maoJM
錨	maoJN
覒	maoJO
鉾	maoJP
袤	maoK
笷	maoKM
耄	maoL
毛	maoM
矛	maoMB
瞀	maoMC
嗎	maOML
毟	maoMM
眊	maoMN
毷	maoMO
氂	maoMP
牦	maoN
嘜	maONL
媢	maoNM
犛	maoNN
鶜	maoNO
猫	maoQ
酕	maoQM
昴	maoR
暓	maoRM
峁	maoS
罞	maoSM
嵍	maoSN
冒	maoT
冇	maoTM
冃	maoTN
冐	maoTO
堥	maoTP
茂	maoU
茅	maoUB
茆	maoUC
芼	maoUM
萺	maoUN
蓩	maoUO
乮	maoVM
瑁	maoW
瓱	maoWM
懋	maoX
夘	maoXM
愗	maoXN
貌	maoZ
貓	maoZM
码	maP
么	maPB
碼	maPM
亇	maPN
礣	maPO
犸	maQ
獁	maQM
罵	maSM
祃	maSN
禡	maSO
菻	maUM
蔴	maUN
傌	maVM
玛	maW
瑪	maWM
鰢	maYM
孖	maZM
遤	maZN
濹	meEM
庅	meGM
抺	meiAM
挴	meiAN
攗	meiAO
寐	meiB
凂	meiBM
痗	meiBN
蝞	meiCM
徾	meiCN
殙	meiDM
没	meiE
湄	meiEB
浼	meiEC
沒	meiEM
沬	meiEN
湈	meiEO
渼	meiEP
郿	meiFM
魅	meiG
鬽	meiGM
煤	meiH
黴	meiHM
煝	meiHN
穈	meiHO
燘	meiHP
黣	meiHQ
梅	meiI
枚	meiIB
楣	meiIC
栂	meiIM
楳	meiIN
槑	meiIO
櫗	meiIP
镁	meiJ
镅	meiJB
鎂	meiJM
鎇	meiJN
鋂	meiJO
袂	meiK
篃	meiKM
脄	meiLM
脢	meiLN
腜	meiLO
每	meiM
眉	meiMB
糜	meiMC
毎	meiMM
眛	meiMN
睂	meiMO
睸	meiMP
妹	meiN
媚	meiNB
媒	meiNC
鹛	meiND
鶥	meiNM
媄	meiNN
媺	meiNO
嬍	meiNP
嚜	meiOM
酶	meiQ
猸	meiQB
霉	meiR
昧	meiRB
嵋	meiS
祙	meiSM
嵄	meiSN
禖	meiSO
躾	meiSP
坆	meiTM
堳	meiTN
塺	meiTO
莓	meiU
苺	meiUM
葿	meiUN
蘪	meiUO
玫	meiW
珻	meiWM
瑂	meiWN
韎	meiWO
美	meiY
謎	meiYM
羙	meiYN
跊	meiZM
麽	meM
麼	meMM
扪	menA
捫	menAM
殙	menDM
満	menEM
鞔	menG
掹	mengAM
擝	mengAN
髳	mengBM
蜢	mengC
虻	mengCB
蠓	mengCC
蝱	mengCM
溕	mengEM
濛	mengEN
鄸	mengFM
鄳	mengFN
庬	mengGM
梦	mengI
檬	mengIB
橗	mengIM
锰	mengJ
錳	mengJM
鋂	mengJN
幪	mengJO
朦	mengL
勐	mengLB
盟	mengM
瞢	mengMB
黽	mengMM
冡	mengMN
氋	mengMO
矇	mengMP
矒	mengMQ
鼆	mengMR
鹲	mengNM
鸏	mengNN
礞	mengP
猛	mengQ
獴	mengQM
雺	mengRM
曚	mengRN
霥	mengRO
靀	mengRP
霿	mengRQ
氓	mengS
罞	mengSM
饛	mengSN
甿	mengTM
蒙	mengU
萌	mengUB
莔	mengUM
萠	mengUN
蕄	mengUO
儚	mengVM
甍	mengW
瓾	mengWM
懵	mengX
夢	mengXM
夣	mengXN
懜	mengXO
懞	mengXP
尨	mengYM
鯍	mengYN
鯭	mengYO
顭	mengYP
孟	mengZ
艨	mengZB
艋	mengZC
焖	menH
燜	menHM
穈	menHN
椚	menIM
钔	menJ
鍆	menJM
门	menM
闷	menMB
門	menMM
瞞	menMN
閅	menMO
暪	menRM
亹	menTM
菛	menUM
虋	menUN
们	menV
們	menVM
玧	menWM
璊	menWN
斖	menWO
懑	menX
悶	menXM
懣	menXN
怋	menXO
悗	menXP
惛	menXQ
嚒	meOM
嚜	meON
嚰	meOO
么	meP
摵	miAM
擟	miAN
宀	mianB
蝒	mianCM
免	mianD
湎	mianE
沔	mianEB
渑	mianEC
澠	mianEM
汅	mianEN
绵	mianF
缅	mianFB
綿	mianFM
緬	mianFN
絻	mianFO
緜	mianFP
丏	mianHM
棉	mianI
杣	mianIM
檰	mianIN
櫋	mianIO
勉	mianL
腼	mianLB
勔	mianLM
面	mianM
眠	mianMB
眄	mianMC
黽	mianMM
靦	mianMN
靣	mianMO
睌	mianMP
麫	mianMQ
麪	mianMR
糆	mianMS
麺	mianMT
矈	mianMU
矊	mianMV
麵	mianMW
矏	mianMX
娩	mianN
婂	mianNM
媔	mianNN
嬵	mianNO
喕	mianOM
牑	mianPM
冕	mianT
芇	mianUM
莬	mianUN
葂	mianUO
俛	mianVM
偭	mianVN
愐	mianXM
鮸	mianYM
臱	mianZM
攠	miAO
描	miaoA
渺	miaoE
淼	miaoEB
缈	miaoF
缪	miaoFB
緲	miaoFM
繆	miaoFN
緢	miaoFO
庙	miaoG
廟	miaoGM
庿	miaoGN
秒	miaoH
杪	miaoI
篎	miaoKM
劰	miaoLM
竗	miaoLN
瞄	miaoM
眇	miaoMB
妙	miaoN
鹋	miaoNB
鶓	miaoNM
媌	miaoNN
嫹	miaoNO
喵	miaoO
厸	miaoSM
苗	miaoU
藐	miaoUB
仯	miaoVM
玅	miaoXM
訬	miaoYM
鱙	miaoYN
邈	miaoZ
宓	miB
羋	miBM
宻	miBN
蜜	miC
蝆	miCM
镾	miCN
鼏	miDM
泌	miE
搣	mieAM
汩	miEB
汨	miEC
蠛	mieCL
滅	mieEM
瀎	mieEN
旀	mieFM
灭	mieH
烕	mieHM
櫗	mieIM
覕	mieJM
幭	mieJN
鑖	mieJO
篾	mieK
簚	mieKM
沕	miEM
眜	mieMM
沵	miEN
鴓	mieNM
咩	mieO
洣	miEOL
吀	mieOM
哶	mieON
淧	miEP
礣	miePM
渳	miEQ
漞	miER
滵	miES
濗	miET
蔑	mieU
濔	miEUL
薎	mieUM
乜	mieV
瀰	miEVL
灖	miEW
懱	mieXM
衊	mieXN
鱴	mieYM
孭	mieZM
靡	miF
糸	miFB
縻	miFC
弥	miG
弭	miGB
彌	miGM
秘	miH
熐	miHM
穈	miHN
爢	miHO
枈	miIM
榓	miIN
樒	miIO
檷	miIP
櫁	miIQ
觅	miJ
覓	miJM
覔	miJN
幎	miJO
覛	miJP
銤	miJQ
幦	miJR
袮	miKM
簚	miKN
麋	miL
脒	miLB
麊	miLM
麛	miLN
米	miM
眯	miMB
糜	miMC
幂	miMD
敉	miME
冖	miMF
瞇	miMM
冪	miMN
冞	miMO
粎	miMP
瞴	miMQ
麿	miMR
抿	minA
捪	minAM
冺	minBM
痻	minBN
賯	minBO
蠠	minCM
刡	minDM
泯	minE
湣	minEM
渂	minEN
湏	minEO
潣	minEP
缗	minF
緡	minFM
緍	minFN
掵	mingAM
凕	mingBM
螟	mingC
溟	mingE
洺	mingEM
鄍	mingFM
椧	mingIM
榠	mingIN
铭	mingJ
銘	mingJM
覭	mingJN
朙	mingLM
冥	mingM
瞑	mingMB
眀	mingMM
眳	mingMN
鸣	mingN
鳴	mingNM
姳	mingNN
嫇	mingNO
名	mingO
酩	mingQ
猽	mingQM
明	mingR
暝	mingRB
茗	mingU
蓂	mingUM
命	mingV
佲	mingVM
慏	mingXM
詺	mingYM
鈱	minJM
錉	minJN
鍲	minJO
笽	minKM
笢	minKN
簢	minKO
勄	minLM
闽	minM
闵	minMB
皿	minMC
黾	minMD
孊	miNML
閩	minMM
閔	minMN
黽	minMO
盿	minMP
鸍	miNN
姄	minNM
鴖	minNN
呡	minOM
砇	minPM
碈	minPN
旻	minRM
旼	minRN
暋	minRO
民	minS
岷	minSB
罠	minSM
崏	minSN
垊	minTM
苠	minU
僶	minVM
敏	minW
玟	minWB
珉	minWC
瑉	minWM
敃	minWN
琝	minWO
琘	minWP
敯	minWQ
悯	minX
愍	minXB
憫	minXM
忟	minXN
忞	minXO
怋	minXP
惽	minXQ
慜	minXR
鳘	minY
鰵	minYM
咪	miO
嘧	miOB
猕	miQ
醚	miQB
獼	miQM
醾	miQN
醿	miQO
釄	miQP
密	miS
祢	miSB
禰	miSM
峚	miSN
祕	miSO
羃	miSP
塓	miTM
蘼	miU
芈	miUB
缪	miuF
繆	miuFM
蒾	miUM
葞	miUN
蓂	miUO
蔝	miUP
蔤	miUQ
藌	miUR
蘪	miUS
谬	miuY
謬	miuYM
侎	miVM
瓕	miWM
尓	miXM
尒	miXN
怽	miXO
戂	miXP
谜	miY
谧	miYB
謎	miYM
謐	miYN
詸	miYO
迷	miZ
摸	moA
摩	moAB
抹	moAC
摹	moAD
擵	moAM
攠	moAN
寞	moB
瘼	moBB
呒	mOBL
皌	moBM
癦	moBN
蛨	moCM
蟔	moCN
殁	moD
歿	moDM
歾	moDN
劘	moDO
漠	moE
没	moEB
沫	moEC
沒	moEM
瀎	moEN
陌	moF
絈	moFM
絔	moFN
縸	moFO
纆	moFP
魔	moG
庅	moGM
靺	moGN
骳	moGO
髍	moGP
默	moH
万	moHB
秣	moHC
無	moHM
黙	moHN
爅	moHO
模	moI
末	moIB
枺	moIM
橅	moIN
镆	moJ
鏌	moJM
帓	moJN
帞	moJO
銆	moJP
袹	moKM
脉	moL
膜	moLB
耱	moLC
蓦	moM
麽	moMB
嘸	mOML
麼	moMM
驀	moMN
眜	moMO
眿	moMP
眽	moMQ
粖	moMR
瞙	moMS
瞐	moMT
糢	moMU
麿	moMV
嬷	moN
嫫	moNB
呣	mONL
嬤	moNM
妺	moNN
嫼	moNO
呒	moO
嘿	moOB
唜	moOM
嗼	moON
嚜	moOO
嚤	moOP
么	moP
磨	moPB
砞	moPM
礳	moPN
狢	moQM
獏	moQN
昩	moRM
暯	moRN
馍	moS
饃	moSM
饝	moSN
墨	moT
冒	moTB
圽	moTM
冐	moTN
塻	moTO
莫	moU
茉	moUB
蘑	moUC
蛑	mouCL
洠	mouEM
缪	mouF
繆	mouFM
鞪	mouGM
某	mouI
桙	mouIM
鍪	mouJ
鉾	mouJM
劺	mouLM
眸	mouM
萬	moUML
麰	mouMM
牟	mouN
莈	moUNL
鴾	mouNM
哞	mouO
藦	moUOL
呣	mouOM
堥	mouTM
侔	mouV
敄	mouWM
恈	mouXM
谋	mouY
謀	mouYM
踎	mouZM
尛	moXM
衇	moXN
懡	moXO
戂	moXP
谟	moY
謨	moYM
魹	moYN
魩	moYO
謩	moYP
貊	moZ
貘	moZB
貃	moZM
貈	moZN
拇	muA
蚞	muCM
沐	muE
繆	muFM
縸	muFN
鞪	muGM
穆	muH
炑	muHM
木	muI
模	muIB
朰	muIM
朷	muIN
楘	muIO
樢	muIP
幕	muJ
钼	muJB
鉬	muJM
凩	muJN
幙	muJO
鉧	muJP
募	muL
胟	muLM
母	muM
目	muMB
睦	muMC
毪	muMD
毣	muMM
氁	muMN
牧	muN
姆	muNB
姥	muNC
牡	muND
牟	muNE
牳	muNM
娒	muNN
呒	muO
嘸	muOM
呣	muON
砪	muPM
狇	muQM
獏	muQN
暮	muR
雮	muRM
暯	muRN
霂	muRO
峔	muSM
亩	muT
墓	muTB
坶	muTC
畝	muTM
畂	muTN
畒	muTO
畆	muTP
畞	muTQ
畮	muTR
苜	muU
莯	muUM
萺	muUN
茻	muUO
仫	muV
慕	muX
慔	muXM
踇	muZM
艒	muZN
拿	naA
捺	naAB
抐	naAM
拏	naAN
挐	naAO
搻	naAP
軜	naCM
那	naF
纳	naFB
納	naFM
郍	naFN
靹	naGM
秅	naHM
搱	naiAM
摨	naiAN
疓	naiBM
螚	naiCM
奈	naiD
鼐	naiDB
耐	naiE
耏	naiEM
渿	naiEN
柰	naiI
釢	naiJM
銰	naiJN
錼	naiJO
褦	naiKM
腉	naiLM
奶	naiN
妳	naiNM
嬭	naiNN
乃	naiP
氖	naiQ
萘	naiU
艿	naiUB
莻	naiUM
佴	naiV
倷	naiVM
廼	naiYM
迺	naiZM
孻	naiZN
钠	naJ
镎	naJB
鈉	naJM
鎿	naJN
衲	naK
袦	naKM
笚	naKN
笝	naKO
肭	naL
乸	naMM
娜	naN
抩	nanAM
揇	nanAN
赧	nanC
蝻	nanCB
湳	nanEM
攮	nangA
搑	nangAM
擃	nangAN
鬞	nangBM
齉	nangBN
蠰	nangCM
涳	nangEM
瀼	nangEN
灢	nangEO
囊	nangH
嚢	nangHM
欜	nangIM
囔	nangO
曩	nangR
馕	nangS
饢	nangSM
乪	nangVM
儾	nangVN
憹	nangXM
煵	nanHM
楠	nanI
枏	nanIM
柟	nanIN
腩	nanL
妠	naNM
妠	nanNM
娚	nanNN
婻	nanNO
嫨	nanNP
喃	nanO
暔	nanRM
南	nanS
男	nanT
畘	nanTM
莮	nanUM
萳	nanUN
侽	nanVM
囡	nanW
囝	nanWB
戁	nanXM
諵	nanYM
难	nanZ
難	nanZM
遖	nanZN
哪	naO
挠	naoA
撓	naoAM
摎	naoAN
呐	naOB
匘	naoBM
蛲	naoC
蟯	naoCM
鬧	naoDM
淖	naoE
橈	naoIM
铙	naoJ
鐃	naoJM
脑	naoL
腦	naoLM
脳	naoLN
臑	naoLO
闹	naoM
吶	naOML
閙	naoMM
嗱	naON
婥	naoNM
嫐	naoNN
呶	naoO
硇	naoP
碙	naoPM
碯	naoPN
猱	naoQ
峱	naoQM
獶	naoQN
獿	naoQO
嶩	naoSM
巎	naoSN
垴	naoT
堖	naoTM
瑙	naoW
恼	naoX
惱	naoXM
怓	naoXN
悩	naoXO
憹	naoXP
詉	naoYM
譊	naoYN
孬	naoZ
夒	naoZM
雫	naRM
蒘	naUM
蒳	naUN
讷	naY
魶	naYM
誽	naYN
豽	naZM
貀	naZN
抐	neAM
疒	neB
浽	neiEM
那	neiF
錗	neiJM
脮	neiLM
腇	neiLN
娞	neiNM
哪	neiO
氝	neiQM
氞	neiQN
內	neiRM
馁	neiS
餒	neiSM
餧	neiSN
内	neiT
鮾	neiYM
鯘	neiYN
眲	neMM
螚	nengCM
能	nengL
嫩	nenN
婩	nenNM
媆	nenNN
硸	nenPM
恁	nenX
呢	neO
哪	neOB
呐	neOC
吶	neOM
讷	neY
訥	neYM
嗯	ngO
唔	ngOB
拟	niA
擬	niAM
抐	niAN
捻	nianA
拈	nianAB
撵	nianAC
撚	nianAM
攆	nianAN
辗	nianC
辇	nianCB
輾	nianCM
輦	nianCN
涊	nianEM
淰	nianEN
溓	nianEO
娘	niangN
嬢	niangNM
孃	niangNN
酿	niangQ
釀	niangQM
醸	niangQN
黏	nianH
廿	nianHB
秊	nianHM
秥	nianHN
焾	nianHO
榐	nianIM
簐	nianKM
粘	nianM
姩	nianNM
鵇	nianNN
哖	nianOM
唸	nianON
年	nianP
碾	nianPB
卄	nianSM
埝	nianT
蔫	nianU
念	nianX
悥	nianXM
惗	nianXN
鲇	nianY
鲶	nianYB
鮎	nianYM
鯰	nianYN
跈	nianZM
艌	nianZN
蹍	nianZO
蹨	nianZP
躎	nianZQ
抳	niAO
溺	niaoE
樢	niaoIM
袅	niaoK
裊	niaoKM
褭	niaoKN
脲	niaoL
鸟	niaoN
嬲	niaoNB
鳥	niaoNM
嫋	niaoNN
嬝	niaoNO
尿	niaoP
茑	niaoU
蔦	niaoUM
掜	niAP
屰	niBM
蚭	niCM
蛪	niCN
蜺	niCO
輗	niCP
齯	niCQ
泥	niE
捏	nieA
摄	nieAB
攝	nieAM
掜	nieAN
揑	nieAO
摰	nieAP
溺	niEB
痆	nieBM
齧	nieCM
蠥	nieCN
涅	nieE
湼	nieEM
聂	nieF
陧	nieFB
聶	nieFM
隉	nieFN
枿	nieIM
槷	nieIN
櫱	nieIO
镊	nieJ
镍	nieJB
鎳	nieJM
鑷	nieJN
帇	nieJO
銸	nieJP
鋷	nieJQ
錜	nieJR
鑈	nieJS
钀	nieJT
篞	nieKM
籋	nieKN
兒	niEM
闑	nieMM
糵	nieMN
糱	nieMO
灄	niEN
啮	nieO
嗫	nieOB
氼	niEOL
嚙	nieOM
囁	nieON
噛	nieOO
囐	nieOP
囓	nieOQ
児	niEP
淣	niEQ
濔	niER
峊	nieSM
嵲	nieSN
嶭	nieSO
巕	nieSP
圼	nieTM
蘖	nieU
苶	nieUM
菍	nieUN
乜	nieV
敜	nieWM
颞	nieY
顳	nieYM
讘	nieYN
孽	nieZ
蹑	nieZB
臬	nieZC
躡	nieZM
踂	nieZN
踙	nieZO
踗	nieZP
臲	nieZQ
孼	nieZR
匿	niF
旎	niFB
郳	niFM
聣	niFN
縌	niFO
隬	niFP
聻	niFQ
秜	niHM
柅	niIM
棿	niIN
檷	niIO
铌	niJ
鈮	niJM
觬	niJN
袮	niKM
腻	niL
膩	niLM
胒	niLN
麑	niLO
睨	niM
籾	niMM
眤	niMN
妮	niN
拰	ninAM
拧	ningA
擰	ningAM
宁	ningB
凝	ningBB
寧	ningBM
寕	ningBN
寍	ningBO
寗	ningBP
寜	ningBQ
鬡	ningBR
泞	ningE
濘	ningEM
澝	ningEN
聍	ningF
聹	ningFM
柠	ningI
檸	ningIM
橣	ningIN
鑏	ningJM
矃	ningMM
嬣	ningNM
鸋	ningNN
咛	ningO
嚀	ningOM
狞	ningQ
獰	ningQM
苧	ningUM
薴	ningUN
佞	ningV
侫	ningVM
倿	ningVN
儜	ningVO
甯	ningY
脌	ninLM
妳	niNM
婗	niNN
嫟	niNO
嬺	niNP
嬭	niNQ
囜	ninWM
您	ninX
呢	niO
尼	niP
屔	niPM
猊	niQ
狔	niQM
霓	niR
昵	niRB
晲	niRM
暱	niRN
臡	niRO
坭	niT
堄	niTM
埿	niTN
蘼	niU
扭	niuA
拗	niuAB
抝	niuAM
汼	niuEM
沑	niuEN
纽	niuF
紐	niuFM
靵	niuGM
炄	niuHM
杻	niuIM
钮	niuJ
鈕	niuJM
苨	niUM
牛	niuN
妞	niuNB
薿	niUNL
牜	niuNM
狃	niuQ
莥	niuUM
忸	niuX
怓	niuXM
你	niV
倪	niVB
伲	niVC
伱	niVM
儞	niVN
儗	niVO
怩	niX
惄	niXM
愵	niXN
馜	niXO
懝	niXP
鲵	niY
鯢	niYM
誽	niYN
逆	niZ
迡	niZM
跜	niZN
孴	niZO
貎	niZP
嗯	nO
唔	nOB
挊	nongAM
挵	nongAN
癑	nongBM
鬞	nongBN
齈	nongBO
農	nongCM
辳	nongCN
浓	nongE
濃	nongEM
繷	nongFM
弄	nongG
秾	nongHM
燶	nongHN
穠	nongHO
檂	nongIM
欁	nongIN
襛	nongKM
脓	nongL
膿	nongLM
农	nongM
哝	nongO
噥	nongOM
醲	nongQM
禯	nongSM
蕽	nongUM
侬	nongV
儂	nongVM
譨	nongYM
搙	nouAM
槈	nouIM
檽	nouIN
鎒	nouJM
鐞	nouJN
耨	nouL
獳	nouQM
譨	nouYM
羺	nouYN
搙	nuAM
渜	nuanEM
湪	nuanEN
煗	nuanHM
煖	nuanHN
奻	nuanNM
暖	nuanR
餪	nuanSM
疟	nueB
瘧	nueBM
虐	nueH
弩	nuG
帑	nuJ
笯	nuKM
努	nuL
驽	nuM
駑	nuMM
奴	nuN
黁	nunMM
嫰	nunNM
挪	nuoA
搦	nuoAB
挼	nuoAM
掿	nuoAN
搙	nuoAO
搻	nuoAP
耎	nuoEM
稬	nuoHM
穤	nuoHN
梛	nuoIM
榒	nuoIN
橠	nuoIO
锘	nuoJ
鍩	nuoJM
袳	nuoKM
袲	nuoKN
糯	nuoM
毭	nuoMM
糑	nuoMN
糥	nuoMO
娜	nuoN
喏	nuoO
傩	nuoV
儺	nuoVM
懦	nuoX
愞	nuoXM
懧	nuoXN
诺	nuoY
諾	nuoYM
詝	nuoYN
難	nuoZM
逽	nuoZN
蹃	nuoZO
砮	nuPM
胬	nuR
伮	nuVM
傉	nuVN
怒	nuX
孥	nuZ
沑	nvEM
聏	nvFM
钕	nvJ
釹	nvJM
朒	nvLM
籹	nvMM
女	nvN
恧	nvX
衄	nvXB
衂	nvXM
筽	oKM
哦	oO
喔	oOB
噢	oOC
嚄	oOM
沤	ouE
漚	ouEM
区	ouF
區	ouFM
髃	ouGM
熰	ouHM
櫙	ouIM
鏂	ouJM
耦	ouL
腢	ouLM
膒	ouLN
鸥	ouN
鷗	ouNM
鴎	ouNN
呕	ouO
嘔	ouOM
吘	ouON
吽	ouOO
殴	ouP
毆	ouPM
欧	ouQ
歐	ouQM
塸	ouTM
藕	ouU
蕅	ouUM
藲	ouUN
偶	ouV
瓯	ouW
甌	ouWM
怄	ouX
慪	ouXM
讴	ouY
謳	ouYM
扒	paA
掱	paAM
皅	paBM
汃	paEM
潖	paEN
杷	paI
排	paiA
拍	paiAB
徘	paiC
輫	paiCM
派	paiE
湃	paiEB
沠	paiEM
渒	paiEN
棑	paiIM
鎃	paiJM
箄	paiKM
簰	paiKN
簲	paiKO
闏	paiMM
犤	paiNM
哌	paiO
牌	paiP
猅	paiQM
蒎	paiU
俳	paiV
廹	paiYM
迫	paiZ
帕	paJ
钯	paJB
鈀	paJM
帊	paJN
筢	paK
袙	paKM
耙	paL
攀	panA
拚	panAB
搫	panAM
冸	panBM
蟠	panC
判	panD
潘	panE
泮	panEB
沜	panEM
洀	panEN
湴	panEO
溿	panEP
瀊	panEQ
縏	panFM
髣	pangBM
彷	pangC
螃	pangCB
厐	pangCM
徬	pangCN
滂	pangE
汸	pangEM
沗	pangEN
旁	pangF
庞	pangG
庬	pangGM
髈	pangGN
炐	pangHM
覫	pangJM
篣	pangKM
胖	pangL
膀	pangLB
耪	pangLC
龐	pangLM
肨	pangLN
胮	pangLO
膖	pangLP
龎	pangLQ
鞶	panGM
眫	pangMM
嫎	pangNM
嗙	pangOM
磅	pangP
乓	pangPB
雱	pangRM
霶	pangRN
攵	pangW
尨	pangYM
鳑	pangYN
鰟	pangYO
逄	pangZ
夂	pangZB
夆	pangZM
趽	pangZN
舽	pangZO
炍	panHM
柈	panIM
槃	panIN
幋	panJM
鋬	panJN
鎜	panJO
鑻	panJP
袢	panK
襻	panKB
褩	panKM
籓	panKN
胖	panL
肨	panLM
膰	panLN
盘	panM
盼	panMB
妑	paNML
盤	panMM
眅	panMN
盻	panMO
眫	panMP
闆	panMQ
媻	panNM
鵥	panNN
磐	panP
爿	panPB
丬	panPC
牉	panPM
碆	panPN
牓	panPO
磻	panPP
畔	panT
番	panTB
坢	panTM
畨	panTN
萠	panUM
蒰	panUN
叛	panY
詊	panYM
頖	panYN
蹒	panZ
蹣	panZM
跘	panZN
啪	paO
抛	paoA
拋	paoAM
疱	paoB
蚫	paoCM
軳	paoCN
刨	paoD
匏	paoDB
奅	paoDM
泡	paoE
颮	paoFM
庖	paoG
瓟	paoGM
鞄	paoGN
炮	paoH
炰	paoHM
烰	paoHN
穮	paoHO
鉋	paoJM
鑤	paoJN
袍	paoK
袌	paoKM
褜	paoKN
脬	paoL
麅	paoLM
脟	paoLN
麃	paoLO
靤	paoMM
麭	paoMN
咆	paoO
嚗	paoOM
皰	paoPM
砲	paoPN
礟	paoPO
礮	paoPP
狍	paoQ
垉	paoTM
萢	paoUM
藨	paoUN
跑	paoZ
爮	paoZM
跁	paoZN
葩	paU
苩	paUM
琶	paW
怕	paX
爬	paZ
趴	paZB
舥	paZM
跁	paZN
抷	peiAM
攈	peiAN
赔	peiB
賠	peiBM
轡	peiCM
沛	peiE
浿	peiEM
陪	peiF
旆	peiFB
阫	peiFM
斾	peiFN
陫	peiFO
柸	peiIM
柭	peiIN
棑	peiIO
帔	peiJ
锫	peiJB
錇	peiJM
裴	peiK
裶	peiKM
裵	peiKN
胚	peiL
肧	peiLM
毰	peiMM
馷	peiMN
妚	peiNM
姵	peiNN
婄	peiNO
媐	peiNP
呸	peiO
辔	peiOB
配	peiQ
醅	peiQB
犻	peiQM
霈	peiR
嶏	peiSM
培	peiT
茷	peiUM
蓜	peiUN
佩	peiV
伂	peiVM
俖	peiVN
珮	peiWM
琣	peiWN
怌	peiXM
衃	peiXN
湓	penE
濆	penEM
捧	pengA
抨	pengAB
挷	pengAM
捀	pengAN
掽	pengAO
摓	pengAP
搒	pengAQ
匉	pengBM
皏	pengBN
痭	pengBO
髼	pengBP
鬅	pengBQ
鬔	pengBR
蟛	pengC
軯	pengCM
輧	pengCN
輣	pengCO
蟚	pengCP
剻	pengDM
澎	pengE
泙	pengEM
淎	pengEN
淜	pengEO
漨	pengEP
漰	pengEQ
絣	pengFM
纄	pengFN
弸	pengGM
烹	pengH
稝	pengHM
熢	pengHN
棚	pengI
梈	pengIM
椪	pengIN
椖	pengIO
樥	pengIP
槰	pengIQ
錋	pengJM
鑝	pengJN
篷	pengK
竼	pengKM
袶	pengKN
篣	pengKO
朋	pengL
膨	pengLB
胓	pengLM
閛	pengMM
駍	pengMN
騯	pengMO
鹏	pengN
鵬	pengNM
嘭	pengO
碰	pengP
砰	pengPB
硼	pengPC
硑	pengPM
磞	pengPN
彭	pengS
堋	pengT
塳	pengTM
塜	pengTN
蓬	pengU
芃	pengUM
莑	pengUN
蘕	pengUO
伻	pengVM
倗	pengVN
傰	pengVO
怦	pengX
恲	pengXM
憉	pengXN
韸	pengYM
韼	pengYN
踫	pengZM
衯	penKM
盆	penM
喷	penO
噴	penOM
呠	penON
喯	penOO
歕	penQM
葐	penUM
瓫	penWM
翉	penYM
翸	penYN
批	piA
披	piAB
擗	piAC
抷	piAM
揊	piAN
貵	pianBM
賆	pianBN
緶	pianFM
骿	pianGM
扁	pianH
楩	pianIM
楄	pianIN
覑	pianJM
篇	pianK
胼	pianL
腁	pianLM
骗	pianM
骈	pianMB
騙	pianMM
駢	pianMN
騈	pianMO
騗	pianMP
犏	pianN
媥	pianNM
鶣	pianNN
片	pianP
猵	pianQM
獱	pianQN
偏	pianV
便	pianVB
囨	pianWM
瑸	pianWN
璸	pianWO
翩	pianY
谝	pianYB
諞	pianYM
魸	pianYN
諚	pianYO
蹁	pianZ
跰	pianZM
髟	piaoB
皫	piaoBM
螵	piaoC
徱	piaoCM
剽	piaoD
殍	piaoDB
漂	piaoE
飘	piaoF
缥	piaoFB
飄	piaoFM
縹	piaoFN
旚	piaoFO
飃	piaoFP
瓢	piaoG
魒	piaoGM
朴	piaoI
篻	piaoKM
勡	piaoLM
瞟	piaoM
骠	piaoMB
驃	piaoMM
闝	piaoMN
驫	piaoMO
嫖	piaoN
犥	piaoNM
嘌	piaoO
醥	piaoQM
票	piaoS
彯	piaoSM
莩	piaoU
蔈	piaoUM
薸	piaoUN
僄	piaoVM
慓	piaoXM
鰾	piaoYM
翲	piaoYN
謤	piaoYO
顠	piaoYP
疲	piB
痞	piBB
癖	piBC
毘	piBM
髬	piBN
蚍	piC
蜱	piCB
蚽	piCM
蚾	piCN
螕	piCO
螷	piCP
蠯	piCQ
劈	piD
淠	piE
撇	pieA
撆	pieAM
潎	pieEM
覕	pieJM
鐅	pieJN
瞥	pieM
潎	piEML
澼	piEN
嫳	pieNM
丿	pieP
氕	pieQ
暼	pieRM
彡	pieS
苤	pieU
匹	piF
纰	piFB
邳	piFC
陂	piFD
陴	piFE
郫	piFF
紕	piFM
阰	piFN
旇	piFO
隦	piFP
鼙	piG
庀	piGB
鞞	piGM
丕	piH
炋	piHM
秠	piHN
秛	piHO
焷	piHP
稫	piHQ
枇	piI
枈	piIM
椑	piIN
榌	piIO
铍	piJ
鈹	piJM
鈚	piJN
釽	piJO
鉟	piJP
鈲	piJQ
銢	piJR
銔	piJS
錍	piJT
錃	piJU
鎞	piJV
被	piK
裨	piKB
笓	piKM
箆	piKN
篺	piKO
脾	piL
肶	piLM
耚	piLN
脴	piLO
腗	piLP
膍	piLQ
睥	piM
毞	piMM
粃	piMN
駓	piMO
闢	piMP
媲	piN
拼	pinA
拚	pinAB
贫	pinB
貧	pinBM
蠙	pinCM
汖	pinEM
聘	pinF
冯	pingB
蚲	pingCM
蛢	pingCN
軿	pingCO
輧	pingCP
泙	pingEM
洴	pingEN
涄	pingEO
淜	pingEP
郱	pingFM
聠	pingFN
缾	pingFO
庰	pingGM
平	pingH
焩	pingHM
枰	pingI
檘	pingIM
凭	pingJ
帡	pingJM
帲	pingJN
幈	pingJO
鉼	pingJP
凴	pingJQ
箳	pingKM
簈	pingKN
胓	pingLM
竮	pingLN
馮	pingMM
娉	pingN
呯	pingOM
屏	pingP
乒	pingPB
砯	pingPM
硑	pingPN
屛	pingPO
岼	pingSM
艵	pingSN
坪	pingT
甹	pingTM
塀	pingTN
苹	pingU
萍	pingUB
蘋	pingUM
荓	pingUN
蓱	pingUO
俜	pingV
倗	pingVM
瓶	pingW
玶	pingWM
甁	pingWN
憑	pingXM
慿	pingXN
评	pingY
鲆	pingYB
評	pingYM
鮃	pingYN
頩	pingYO
穦	pinHM
榀	pinI
朩	pinIM
妚	piNM
矉	pinMM
驞	pinMN
嫔	pinN
姘	pinNB
牝	pinNC
嫓	piNNL
嬪	pinNM
娦	pinNN
品	pinO
鴄	piNOL
嚬	pinOM
鵧	piNP
砏	pinPM
礗	pinPN
鷿	piNQ
鸊	piNR
蘋	pinUM
薲	pinUN
玭	pinWM
琕	pinWN
馪	pinXM
频	pinY
颦	pinYB
頻	pinYM
顰	pinYN
啤	piO
否	piOB
噼	piOC
噽	piOM
嚊	piON
嚭	piOO
皮	piP
屁	piPB
砒	piPC
磇	piPM
礔	piPN
礕	piPO
狉	piQM
狓	piQN
猈	piQO
霹	piR
朇	piRM
罴	piS
罷	piSM
羆	piSN
岯	piSO
崥	piSP
禆	piSQ
嶏	piSR
毗	piT
坯	piTB
圮	piTC
埤	piTD
壀	piTM
疈	piTN
芘	piU
苉	piUM
僻	piV
仳	piVB
伓	piVM
伾	piVN
琵	piW
甓	piWB
辟	piX
怶	piXM
悂	piXN
憵	piXO
譬	piY
翍	piYM
鲏	piYN
魮	piYO
諀	piYP
魾	piYQ
鮍	piYR
貔	piZ
疋	piZB
豼	piZM
豾	piZN
掊	poA
搫	poAM
魄	poB
皤	poBB
髲	poBM
尀	poCM
尃	poCN
奤	poDM
泼	poE
泊	poEB
泺	poEC
潑	poEM
濼	poEN
洦	poEO
湐	poEP
溌	poEQ
叵	poF
繁	poFB
鄱	poFC
陂	poFD
髆	poGM
烞	poHM
朴	poI
桲	poIM
櫇	poIN
钋	poJ
钷	poJB
釙	poJM
鉕	poJN
巿	poJO
鏺	poJP
笸	poK
箥	poKM
粕	poM
駊	poMM
婆	poN
哱	poOM
嘙	poON
嚩	poOO
破	poP
颇	poPB
砶	poPM
酦	poQM
猼	poQN
醗	poQO
醱	poQP
昢	poRM
岶	poSM
岥	poSN
坡	poT
掊	pouA
抔	pouAM
抙	pouAN
捊	pouAO
剖	pouD
棓	pouIM
裒	pouK
箁	pouKM
襃	pouKN
蒪	poUM
蔢	poUN
娝	pouNM
婄	pouNN
犃	pouNO
咅	pouOM
哣	pouON
垺	pouTM
珀	poW
攴	poWB
敀	poWM
馞	poXM
覇	poXN
頗	poYM
廹	poYN
翍	poYO
謈	poYP
迫	poZ
扑	puA
撲	puAM
抪	puAN
捗	puAO
擈	puAP
匍	puB
痡	puBM
贌	puBN
瀑	puE
浦	puEB
濮	puEC
溥	puED
潽	puEM
陠	puFM
纀	puFN
巬	puGM
炇	puHM
烳	puHN
秿	puHO
穙	puHP
朴	puI
樸	puIM
柨	puIN
檏	puIO
铺	puJ
镨	puJB
镤	puJC
鋪	puJM
鏷	puJN
鐠	puJO
襆	puKM
箁	puKN
脯	puL
氆	puM
毬	puMM
駇	puMN
瞨	puMO
鵏	puNM
噗	puO
酺	puQM
獛	puQN
普	puR
暴	puRB
曝	puRC
暜	puRM
埔	puT
堡	puTB
圤	puTM
墣	puTN
菩	puU
葡	puUB
蒲	puUC
莆	puUD
蒱	puUM
仆	puV
僕	puVM
舖	puVN
舗	puVO
圃	puW
璞	puWB
攴	puWC
圑	puWM
谱	puY
譜	puYM
菐	puYN
諩	puYO
鯆	puYP
蹼	puZ
掐	qiaA
抲	qiaAM
拤	qiaAN
揢	qiaAO
擖	qiaAP
冾	qiaBM
夹	qiaD
殎	qiaDM
洽	qiaE
匼	qiaFM
髂	qiaG
鞐	qiaGM
帢	qiaJM
袷	qiaK
卡	qiaL
胢	qiaLM
扢	qiAM
扱	qiAN
搴	qianA
掮	qianAB
扦	qianAC
扲	qianAM
拑	qianAN
拪	qianAO
挳	qianAP
掅	qianAQ
揵	qianAR
揃	qianAS
掔	qianAT
摼	qianAU
撁	qianAV
撍	qianAW
攑	qianAX
攐	qianAY
攓	qianAZ
褰	qianB
皘	qianBM
鬝	qianBN
鬜	qianBO
臤	qianCM
蚈	qianCN
蚙	qianCO
軡	qianCP
蜸	qianCQ
輤	qianCR
厱	qianCS
前	qianD
刋	qianDM
浅	qianE
潜	qianEB
淺	qianEM
潛	qianEN
汘	qianEO
汧	qianEP
濳	qianEQ
灊	qianER
纤	qianF
阡	qianFB
缱	qianFC
繾	qianFM
綪	qianFN
縴	qianFO
抢	qiangA
搶	qiangAM
摤	qiangAN
摪	qiangAO
羌	qiangB
蜣	qiangC
將	qiangCM
溬	qiangEM
漒	qiangEN
繈	qiangFM
繦	qiangFN
强	qiangG
戗	qiangGB
戕	qiangGC
強	qiangGM
戧	qiangGN
廧	qiangGO
彊	qiangGP
炝	qiangH
熗	qiangHM
枪	qiangI
樯	qiangIB
槍	qiangIM
檣	qiangIN
椌	qiangIO
锵	qiangJ
镪	qiangJB
锖	qiangJC
錆	qiangJM
鏘	qiangJN
鏹	qiangJO
斨	qiangJP
鎗	qiangJQ
襁	qiangK
篬	qiangKM
腔	qiangL
谸	qianGM
嫱	qiangN
靬	qianGNL
嬙	qiangNM
鶬	qiangNN
呛	qiangO
韆	qianGOL
嗆	qiangOM
唴	qiangON
啌	qiangOO
嗴	qiangOP
将	qiangP
矼	qiangPM
牄	qiangPN
牆	qiangPO
猐	qiangQM
獇	qiangQN
嶈	qiangSM
墙	qiangT
墻	qiangTM
墏	qiangTN
蔷	qiangU
薔	qiangUM
蔃	qiangUN
蘠	qiangUO
玱	qiangWM
瑲	qiangWN
羟	qiangY
羥	qiangYM
羗	qiangYN
羫	qiangYO
謒	qiangYP
羻	qiangYQ
跄	qiangZ
蹌	qiangZM
蹡	qiangZN
艢	qiangZO
黔	qianH
虔	qianHB
炶	qianHM
煔	qianHN
黚	qianHO
椠	qianI
槧	qianIM
杄	qianIN
棈	qianIO
榩	qianIP
槏	qianIQ
橬	qianIR
檶	qianIS
櫏	qianIT
钱	qianJ
钳	qianJB
铅	qianJC
钎	qianJD
钤	qianJE
鉗	qianJM
鉛	qianJN
錢	qianJO
鈐	qianJP
釺	qianJQ
鈆	qianJR
銭	qianJS
鎆	qianJT
鏲	qianJU
鑓	qianJV
鐱	qianJW
鑯	qianJX
签	qianK
箝	qianKB
凵	qianKC
簽	qianKM
兛	qianKN
箞	qianKO
篏	qianKP
篟	qianKQ
籖	qianKR
籤	qianKS
肷	qianL
膁	qianLM
竏	qianLN
骞	qianM
騫	qianMM
粁	qianMN
馯	qianMO
騝	qianMP
騚	qianMQ
牵	qianN
犍	qianNB
牽	qianNM
鶼	qianNN
奷	qianNO
婜	qianNP
媊	qianNQ
鹐	qianNR
鳽	qianNS
嬱	qianNT
鵮	qianNU
孅	qianNV
唊	qianOM
嗛	qianON
千	qianP
磏	qianPM
欠	qianQ
歉	qianQB
欦	qianQM
欿	qianQN
歁	qianQO
朁	qianRM
嵌	qianS
岍	qianSB
岒	qianSM
嵰	qianSN
堑	qianT
塹	qianTM
圲	qianTN
圱	qianTO
墘	qianTP
壍	qianTQ
茜	qianU
芊	qianUB
荨	qianUC
芡	qianUD
蕁	qianUM
茾	qianUN
葥	qianUO
蒨	qianUP
蔳	qianUQ
乾	qianV
倩	qianVB
佥	qianVC
仟	qianVD
僉	qianVM
伣	qianVN
仱	qianVO
乹	qianVP
俔	qianVQ
偂	qianVR
亁	qianVS
傔	qianVT
儙	qianVU
瓩	qianWM
玪	qianWN
悭	qianX
愆	qianXB
慊	qianXC
慳	qianXM
忴	qianXN
悓	qianXO
谦	qianY
谴	qianYB
謙	qianYM
譴	qianYN
諐	qianYO
羬	qianYP
顅	qianYQ
鰬	qianYR
鰜	qianYS
迁	qianZ
遣	qianZB
遷	qianZM
歬	qianZN
孯	qianZO
雃	qianZP
掑	qiAO
撬	qiaoA
摮	qiaoAM
撽	qiaoAN
癄	qiaoBM
蟜	qiaoCM
削	qiaoD
劁	qiaoDB
潐	qiaoEM
缲	qiaoF
繰	qiaoFM
陗	qiaoFN
郻	qiaoFO
鄡	qiaoFP
鄥	qiaoFQ
繑	qiaoFR
巧	qiaoG
敲	qiaoGB
鞘	qiaoGC
鞒	qiaoGD
鞽	qiaoGM
髚	qiaoGN
骹	qiaoGO
鞩	qiaoGP
髜	qiaoGQ
丂	qiaoHM
燆	qiaoHN
燋	qiaoHO
桥	qiaoI
樵	qiaoIB
橇	qiaoIC
橋	qiaoIM
槗	qiaoIN
橾	qiaoIO
櫵	qiaoIP
锹	qiaoJ
鍬	qiaoJM
帩	qiaoJN
釥	qiaoJO
幓	qiaoJP
幧	qiaoJQ
鍫	qiaoJR
鏒	qiaoJS
鐈	qiaoJT
鐰	qiaoJU
箾	qiaoKM
勪	qiaoLM
瞧	qiaoM
睄	qiaoMM
嫶	qiaoNM
犞	qiaoNN
喬	qiaoOM
喿	qiaoON
嘺	qiaoOO
噭	qiaoOP
乔	qiaoP
硗	qiaoPB
殼	qiaoPM
磽	qiaoPN
殻	qiaoPO
硚	qiaoPP
毃	qiaoPQ
磝	qiaoPR
碻	qiaoPS
礄	qiaoPT
礉	qiaoPU
峭	qiaoS
壳	qiaoSB
峤	qiaoSC
嶠	qiaoSM
嵪	qiaoSN
墝	qiaoTM
墧	qiaoTN
墽	qiaoTO
荞	qiaoU
蕎	qiaoUM
荍	qiaoUN
菬	qiaoUO
藮	qiaoUP
侨	qiaoV
俏	qiaoVB
僑	qiaoVM
偢	qiaoVN
僺	qiaoVO
韒	qiaoWM
悄	qiaoX
窍	qiaoXB
憔	qiaoXC
愀	qiaoXD
竅	qiaoXM
翘	qiaoY
诮	qiaoYB
谯	qiaoYC
翹	qiaoYM
誚	qiaoYN
譙	qiaoYO
頝	qiaoYP
譑	qiaoYQ
顦	qiaoYR
跷	qiaoZ
雀	qiaoZB
蹺	qiaoZM
踍	qiaoZN
趬	qiaoZO
趫	qiaoZP
蹻	qiaoZQ
躈	qiaoZR
捿	qiAP
硈	qiaPM
磍	qiaPN
摖	qiAQ
酠	qiaQM
峠	qiaSM
圶	qiaTM
葜	qiaU
恰	qiaX
愘	qiaXM
鮚	qiaYM
跒	qiaZM
其	qiB
凄	qiBB
疧	qiBM
鬐	qiBN
蜞	qiC
蛴	qiCB
蟣	qiCM
蠐	qiCN
蚑	qiCO
蚚	qiCP
蚔	qiCQ
軝	qiCR
蜝	qiCS
螧	qiCT
螇	qiCU
蟿	qiCV
奇	qiD
契	qiDB
豈	qiDM
剘	qiDN
汽	qiE
挈	qieA
泣	qiEB
癿	qieBM
漆	qiEC
厒	qieCM
蛪	qieCN
蛣	qieCO
切	qieD
淇	qiEDL
沏	qiEE
洯	qieEM
淁	qieEN
郄	qieF
汔	qiEFL
匧	qieFM
緁	qieFN
聺	qieFO
且	qieH
稧	qieHM
穕	qieHN
栔	qieIM
椄	qieIN
锲	qieJ
鍥	qieJM
帹	qieJN
鐑	qieJO
箧	qieK
篋	qieKM
笡	qieKN
籡	qieKO
淒	qiEM
妾	qieN
亝	qiENL
洓	qiEO
嗛	qieOM
済	qiEP
湆	qiEQ
猰	qieQM
湇	qiER
朅	qieRM
滊	qiES
濝	qiET
茄	qieU
苆	qieUM
藒	qieUN
伽	qieV
倢	qieVM
窃	qieX
怯	qieXB
惬	qieXC
慊	qieXD
竊	qieXM
愜	qieXN
悏	qieXO
鯜	qieYM
趄	qieZ
疌	qieZM
跙	qieZN
踥	qieZO
旗	qiF
绮	qiFB
缉	qiFC
綦	qiFD
緝	qiFM
綺	qiFN
邔	qiFO
郪	qiFP
旂	qiFQ
陭	qiFR
隑	qiFS
紪	qiFT
綨	qiFU
緀	qiFV
綥	qiFW
緕	qiFX
鄿	qiFY
罊	qiFZ
纃	qiFZL
弃	qiG
戚	qiGB
鬾	qiGM
鬿	qiGN
魌	qiGO
魕	qiGP
鼜	qiGQ
七	qiH
稽	qiHB
亟	qiHC
丌	qiHD
亓	qiHE
炁	qiHM
焏	qiHN
稘	qiHO
棋	qiI
栖	qiIB
杞	qiIC
柒	qiID
槭	qiIE
桤	qiIF
棲	qiIM
棄	qiIN
榿	qiIO
栔	qiIP
梩	qiIQ
桼	qiIR
棊	qiIS
棨	qiIT
櫀	qiIU
檱	qiIV
帺	qiJM
釮	qiJN
锜	qiJO
觭	qiJP
錡	qiJQ
鏚	qiJR
鐑	qiJS
袳	qiKM
褀	qiKN
褄	qiKO
簯	qiKP
簱	qiKQ
籏	qiKR
期	qiL
麒	qiLB
脐	qiLC
耆	qiLD
臍	qiLM
肐	qiLN
肵	qiLO
竒	qiLP
竐	qiLQ
朞	qiLR
麡	qiLS
骑	qiM
骐	qiMB
騎	qiMM
騏	qiMN
盀	qiMO
盵	qiMP
粸	qiMQ
闙	qiMR
騹	qiMS
妻	qiN
擒	qinA
揿	qinAB
撳	qinAM
扲	qinAN
抋	qinAO
捦	qinAP
搇	qinAQ
寝	qinB
寢	qinBM
寑	qinBN
寖	qinBO
瘽	qinBP
寴	qinBQ
螓	qinC
蚙	qinCM
螼	qinCN
蠄	qinCO
沁	qinE
溱	qinEB
澿	qinEM
瀙	qinEN
耹	qinFM
綅	qinFN
廑	qinG
擎	qingA
掅	qingAM
擏	qingAN
凊	qingBM
寈	qingBN
轻	qingC
蜻	qingCB
輕	qingCM
軽	qingCN
剠	qingDM
殑	qingDN
清	qingE
淸	qingEM
渹	qingEN
漀	qingEO
濪	qingEP
罄	qingF
綮	qingFB
郬	qingFM
綪	qingFN
庆	qingG
庼	qingGM
廎	qingGN
黥	qingH
檠	qingI
檾	qingIM
棾	qingIN
樈	qingIO
櫦	qingIP
卿	qingJ
親	qingJM
錆	qingJN
鑋	qingJO
箐	qingK
亲	qingL
勍	qingLM
庈	qinGM
靲	qinGN
啨	qingOM
磬	qingP
殸	qingPM
硘	qingPN
硜	qingPO
碃	qingPP
青	qingQ
氢	qingQB
氰	qingQC
氫	qingQM
靑	qingQN
靘	qingQO
晴	qingR
暒	qingRM
甠	qingSM
埥	qingTM
苘	qingU
葝	qingUM
倾	qingV
傾	qingVM
儬	qingVN
圊	qingW
情	qingX
慶	qingXM
夝	qingXN
请	qingY
顷	qingYB
謦	qingYC
鲭	qingYD
頃	qingYM
請	qingYN
鯖	qingYO
秦	qinH
檎	qinI
櫬	qinIM
梫	qinIN
钦	qinJ
锓	qinJB
親	qinJM
鋟	qinJN
鈙	qinJO
鈫	qinJP
斳	qinJQ
衾	qinK
笉	qinKM
亲	qinL
勤	qinLB
肣	qinLM
矜	qinM
娸	qiNML
矝	qinMM
骎	qinMN
駸	qinMO
婍	qiNN
媇	qinNM
嫀	qinNN
鳹	qinNO
鵭	qinNP
噙	qinO
嗪	qinOB
吣	qinOC
鵸	qiNOL
唚	qinOM
吢	qinON
鶈	qiNP
鶀	qiNQ
欽	qinQM
昑	qinRM
嵚	qinSM
嵰	qinSN
嶜	qinSO
嶔	qinSP
坅	qinTM
埁	qinTN
埐	qinTO
墐	qinTP
芹	qinU
芩	qinUB
蘄	qinUM
菦	qinUN
菣	qinUO
菳	qinUP
藽	qinUQ
侵	qinV
禽	qinVB
儭	qinVM
琴	qinW
珡	qinWM
琹	qinWN
覃	qinX
忴	qinXM
慬	qinXN
懄	qinXO
懃	qinXP
頜	qinYM
誛	qinYN
顉	qinYO
鮼	qinYP
赾	qinZM
雂	qinZN
器	qiO
启	qiOB
嘁	qiOC
啟	qiOM
呚	qiON
宆	qiongBM
蛩	qiongC
蛬	qiongCM
邛	qiongF
煢	qiongHM
焭	qiongHN
焪	qiongHO
熍	qiongHP
桏	qiongIM
橩	qiongIN
銎	qiongJ
卭	qiongJM
筇	qiongK
笻	qiongKM
睘	qiongMM
瞏	qiongMN
嬛	qiongNM
茕	qiongU
藑	qiongUM
藭	qiongUN
儝	qiongVM
琼	qiongW
瓊	qiongWM
琁	qiongWN
璚	qiongWO
瓗	qiongWP
穷	qiongX
穹	qiongXB
窮	qiongXM
惸	qiongXN
憌	qiongXO
竆	qiongXP
跫	qiongZ
赹	qiongZM
舼	qiongZN
呇	qiOO
呮	qiOP
咠	qiOQ
唘	qiOR
唭	qiOS
啔	qiOT
啓	qiOU
喰	qiOV
噐	qiOW
砌	qiP
碛	qiPB
磧	qiPM
矵	qiPN
碁	qiPO
碕	qiPP
毄	qiPQ
碶	qiPR
磎	qiPS
磩	qiPT
磜	qiPU
礘	qiPV
气	qiQ
齐	qiQB
欺	qiQC
欹	qiQD
氣	qiQM
齊	qiQN
気	qiQO
欫	qiQP
猉	qiQQ
玂	qiQR
晵	qiRM
暣	qiRN
霋	qiRO
岂	qiS
祺	qiSB
祈	qiSC
崎	qiSD
祁	qiSE
岐	qiSF
屺	qiSG
岓	qiSM
祇	qiSN
嵜	qiSO
禥	qiSP
禨	qiSQ
畦	qiT
圻	qiTB
畁	qiTM
埼	qiTN
墄	qiTO
葺	qiU
扏	qiuAM
捄	qiuAN
搝	qiuAO
萋	qiUB
赇	qiuBB
鼽	qiuBL
賕	qiuBM
虬	qiuC
蚯	qiuCB
蝤	qiuCC
蕲	qiUCL
虯	qiuCM
蛷	qiuCN
蝵	qiuCO
蟗	qiuCP
蠤	qiuCQ
荠	qiUD
殏	qiuDM
求	qiuE
湫	qiuEB
泅	qiuEC
萁	qiUEL
汓	qiuEM
浗	qiuEN
湭	qiuEO
渞	qiuEP
湬	qiuEQ
邱	qiuF
芪	qiUFL
紌	qiuFM
絿	qiuFN
緧	qiuFO
巯	qiuG
龟	qiuGB
芑	qiUGL
龜	qiuGM
巰	qiuGN
鞦	qiuGO
鞧	qiuGP
龝	qiuGQ
秋	qiuH
丠	qiuHM
秌	qiuHN
煪	qiuHO
穐	qiuHP
楸	qiuI
朹	qiuIM
梂	qiuIN
橚	qiuIO
釓	qiuJM
觓	qiuJN
釚	qiuJO
釻	qiuJP
觩	qiuJQ
銶	qiuJR
裘	qiuK
篍	qiuKM
肍	qiuLM
糗	qiuM
薺	qiUML
毬	qiuMM
盚	qiuMN
蘄	qiUN
牫	qiuNM
媝	qiuNN
鹙	qiuNO
鶖	qiuNP
芞	qiUO
叴	qiuOM
唒	qiuON
丘	qiuP
萕	qiUPL
皳	qiuPM
酋	qiuQ
犰	qiuQB
藄	qiUQL
醔	qiuQM
藒	qiUR
厹	qiuSM
崷	qiuSN
坵	qiuTM
塸	qiuTN
芁	qiuUM
莍	qiuUN
萩	qiuUO
蓲	qiuUP
蘒	qiuUQ
仇	qiuV
俅	qiuVB
球	qiuW
囚	qiuWB
玌	qiuWM
璆	qiuWN
恘	qiuXM
恷	qiuXN
鳅	qiuY
鰍	qiuYM
讎	qiuYN
訄	qiuYO
訅	qiuYP
頄	qiuYQ
鮂	qiuYR
鯄	qiuYS
鰌	qiuYT
鰽	qiuYU
讐	qiuYV
遒	qiuZ
逑	qiuZB
逎	qiuZM
趥	qiuZN
企	qiV
乞	qiVB
俟	qiVC
倛	qiVM
傶	qiVN
僛	qiVO
琪	qiW
琦	qiWB
玘	qiWM
斉	qiWN
斊	qiWO
敧	qiWP
甈	qiWQ
璂	qiWR
憩	qiX
忔	qiXM
忯	qiXN
恓	qiXO
悽	qiXP
夡	qiXQ
愒	qiXR
愭	qiXS
慽	qiXT
慼	qiXU
憇	qiXV
懠	qiXW
鳍	qiY
颀	qiYB
讫	qiYC
訖	qiYM
頎	qiYN
鰭	qiYO
諆	qiYP
諬	qiYQ
鲯	qiYR
鯕	qiYS
起	qiZ
歧	qiZB
蹊	qiZC
迄	qiZD
迉	qiZM
跂	qiZN
攲	qiZO
趞	qiZP
踑	qiZQ
踦	qiZR
艩	qiZS
躩	qiZT
抾	quAM
拳	quanA
捲	quanAM
搼	quanAN
痊	quanB
鬈	quanBB
蜷	quanC
辁	quanCB
輇	quanCM
齤	quanCN
蠸	quanCO
券	quanD
奍	quanDM
泉	quanE
汱	quanEM
洤	quanEN
湶	quanEO
灥	quanEP
绻	quanF
綣	quanFM
絟	quanFN
縓	quanFO
酄	quanFP
弮	quanGM
烇	quanHM
权	quanI
權	quanIM
棬	quanIN
椦	quanIO
楾	quanIP
槫	quanIQ
権	quanIR
铨	quanJ
銓	quanJM
巻	quanJN
觠	quanJO
鐉	quanJP
筌	quanK
箞	quanKM
劝	quanL
勸	quanLM
腃	quanLN
勧	quanLO
駩	quanMM
闎	quanMN
騡	quanMO
矔	quanMP
姾	quanNM
牷	quanNN
牶	quanNO
婘	quanNP
犈	quanNQ
孉	quanNR
啳	quanOM
硂	quanPM
犬	quanQ
犭	quanQB
醛	quanQC
狋	quanQM
峑	quanSM
巏	quanSN
畎	quanT
埢	quanTM
荃	quanU
葲	quanUM
虇	quanUN
全	quanV
佺	quanVM
圈	quanW
圏	quanWM
瑔	quanWN
韏	quanWO
悛	quanX
恮	quanXM
惓	quanXN
诠	quanY
颧	quanYB
顴	quanYM
詮	quanYN
犮	quanYO
鳈	quanYP
鰁	quanYQ
跧	quanZM
踡	quanZN
癯	quB
髷	quBM
蛆	quC
蛐	quCB
衢	quCC
蠼	quCD
龋	quCE
齲	quCM
衐	quCN
蚼	quCO
軥	quCP
蝺	quCQ
螶	quCR
蟝	quCS
忂	quCT
蠷	quCU
刞	quDM
搉	queAM
瘸	queB
蚗	queCM
汋	queEM
缺	queF
缼	queFM
炔	queH
燩	queHM
榷	queI
棤	queIM
却	queJ
卻	queJM
阙	queM
阕	queMB
浀	quEML
闋	queMM
闕	queMN
鹊	queN
淭	quENL
鵲	queNM
灈	quEO
确	queP
確	quePM
殻	quePN
硞	quePO
皵	quePP
碏	quePQ
毃	quePR
碻	quePS
礐	quePT
礭	quePU
崅	queSM
埆	queTM
塙	queTN
墧	queTO
蒛	queUM
傕	queVM
琷	queWM
敠	queWN
敪	queWO
悫	queX
愨	queXM
慤	queXN
雀	queZ
趞	queZM
躤	queZN
区	quF
區	quFM
匤	quFN
阹	quFO
郥	quFP
紶	quFQ
絇	quFR
匷	quFS
戵	quGM
黢	quH
焌	quHM
煀	quHN
爠	quHO
渠	quI
欋	quIM
欔	quIN
觑	quJ
覷	quJM
斪	quJN
覰	quJO
覻	quJP
鐻	quJQ
鑺	quJR
袪	quKM
筁	quKN
籧	quKO
曲	quL
朐	quLB
劬	quLC
胠	quLM
胊	quLN
竘	quLO
耝	quLP
脥	quLQ
竬	quLR
臞	quLS
驱	quM
麴	quMB
阒	quMC
氍	quMD
驅	quMM
麯	quMN
闃	quMO
粬	quMP
駆	quMQ
麹	quMR
駈	quMS
閴	quMT
麮	quMU
鼁	quMV
娶	quN
鸲	quNB
宭	qunBM
帬	qunJM
裙	qunK
裠	qunKM
箘	qunKN
麇	qunL
麕	qunLM
鴝	quNM
鶌	quNN
鸜	quNO
歏	qunQM
峮	qunSM
囷	qunWM
群	qunY
羣	qunYM
逡	qunZ
夋	qunZM
踆	qunZN
呿	quOM
唟	quON
屈	quP
磲	quPB
欪	quQM
去	quS
躯	quSB
岖	quSC
祛	quSD
彡	quSE
軀	quSM
嶇	quSN
厺	quSO
岴	quSP
鼩	quSQ
坥	quTM
蕖	quU
蘧	quUB
苣	quUC
菃	quUM
葋	quUN
佢	quVM
佉	quVN
伹	quVO
璩	quW
璖	quWM
敺	quWN
憈	quXM
取	quY
诎	quYB
詘	quYM
翑	quYN
詓	quYO
誳	quYP
魼	quYQ
鮈	quYR
翵	quYS
鰸	quYT
鱋	quYU
趣	quZ
趋	quZB
瞿	quZC
趨	quZM
迲	quZN
趍	quZO
跼	quZP
趜	quZQ
躣	quZR
髯	ranB
髥	ranBM
蚺	ranC
蚦	ranCM
繎	ranFM
攘	rangA
鬤	rangBM
瀼	rangEM
纕	rangFM
瓤	rangG
穰	rangH
穣	rangHM
爙	rangHN
勷	rangLM
嚷	rangO
獽	rangQM
禳	rangS
壤	rangT
壌	rangTM
蘘	rangUM
儴	rangVM
懹	rangXM
让	rangY
讓	rangYM
譲	rangYN
躟	rangZM
然	ranH
燃	ranHB
熯	ranHM
染	ranI
橪	ranIM
衻	ranKM
袇	ranKN
袡	ranKO
肰	ranLM
姌	ranNM
媣	ranNN
呥	ranOM
嘫	ranON
冉	ranT
冄	ranTM
苒	ranU
蒅	ranUM
珃	ranWM
扰	raoA
擾	raoAM
绕	raoF
繞	raoFM
隢	raoFN
穘	raoHM
桡	raoI
橈	raoIM
襓	raoKM
娆	raoN
嬈	raoNM
犪	raoNN
饶	raoS
饒	raoSM
荛	raoU
蕘	raoUM
遶	raoZM
罖	raSM
捼	reAM
渃	reEM
热	reH
熱	reHM
扨	renAM
轫	renC
軔	renCM
刃	renD
刄	renDM
涊	renEM
纫	renF
紉	renFM
纴	renFN
紝	renFO
絍	renFP
綛	renFQ
扔	rengA
陾	rengFM
靭	renGM
靱	renGN
礽	rengSM
芿	rengUM
仍	rengV
辸	rengZM
稔	renH
秂	renHM
秹	renHN
朲	renIM
杒	renIN
栣	renIO
栠	renIP
梕	renIQ
棯	renIR
釰	renJM
釼	renJN
鈓	renJO
銋	renJP
衽	renK
袵	renKM
肕	renLM
腍	renLN
妊	renN
牣	renNM
姙	renNN
鵀	renNO
壬	renP
饪	renS
飪	renSM
屻	renSN
祍	renSO
躵	renSP
餁	renSQ
荏	renU
葚	renUB
芢	renUM
荵	renUN
菍	renUO
人	renV
任	renVB
仁	renVC
仞	renVD
亻	renVE
仭	renVM
韧	renW
韌	renWM
忍	renX
忈	renXM
忎	renXN
认	renY
認	renYM
讱	renYN
訒	renYO
魜	renYP
喏	reO
惹	reX
釰	riJM
釼	riJN
鈤	riJO
衵	riKM
驲	riMM
馹	riMN
氜	riQM
日	riR
囸	riWM
搑	rongAM
搈	rongAN
容	rongB
宂	rongBM
髶	rongBN
融	rongC
蝾	rongCB
蠑	rongCM
軵	rongCN
螎	rongCO
溶	rongE
瀜	rongEM
绒	rongF
絨	rongFM
縙	rongFN
戎	rongG
熔	rongH
烿	rongHM
穁	rongHN
穃	rongHO
爃	rongHP
榕	rongI
榮	rongIM
栄	rongIN
榵	rongIO
槦	rongIP
镕	rongJM
鎔	rongJN
褣	rongKM
肜	rongL
冗	rongM
毧	rongMM
駥	rongMN
氄	rongMO
媶	rongNM
嫆	rongNN
嬫	rongNO
狨	rongQ
曧	rongRM
嵘	rongS
嶸	rongSM
峵	rongSN
嵤	rongSO
坈	rongTM
荣	rongU
蓉	rongUB
茸	rongUC
茙	rongUM
傇	rongVM
傛	rongVN
瑢	rongWM
羢	rongYM
揉	rouA
宍	rouBM
髳	rouBN
蝚	rouCM
輮	rouCN
渘	rouEM
鞣	rouG
煣	rouHM
柔	rouI
楺	rouIM
鍒	rouJM
脜	rouLM
腬	rouLN
糅	rouM
粈	rouMM
騥	rouMN
媃	rouNM
鶔	rouNN
肉	rouR
厹	rouSM
禸	rouTM
莥	rouUM
葇	rouUN
瑈	rouWM
韖	rouWN
瓇	rouWO
鰇	rouYM
譳	rouYN
蹂	rouZ
扖	ruAM
挐	ruAN
撋	ruanAM
软	ruanC
軟	ruanCM
蝡	ruanCN
輭	ruanCO
耎	ruanEM
阮	ruanF
緛	ruanFM
燸	ruanHM
檽	ruanIM
朊	ruanL
腝	ruanLM
媆	ruanNM
碝	ruanPM
礝	ruanPN
堧	ruanTM
壖	ruanTN
偄	ruanVM
瑌	ruanWM
瓀	ruanWN
擩	ruAO
辱	ruC
蠕	ruCB
蝡	ruCM
汝	ruE
濡	ruEB
溽	ruEC
洳	ruED
渪	ruEM
缛	ruF
縟	ruFM
邚	ruFN
鄏	ruFO
繻	ruFP
抐	ruiAM
兌	ruiBM
蚋	ruiC
蜹	ruiCM
兊	ruiEM
汭	ruiEN
緌	ruiFM
繠	ruiFN
枘	ruiI
桵	ruiIM
橤	ruiIN
锐	ruiJ
銳	ruiJM
鋭	ruiJN
鏸	ruiJO
笍	ruiKM
睿	ruiM
杁	ruIML
桇	ruIN
檽	ruIO
甤	ruiSM
壡	ruiTM
蕊	ruiU
芮	ruiUB
蕤	ruiUC
苼	ruiUM
蕋	ruiUN
蘃	ruiUO
蘂	ruiUP
瑞	ruiW
惢	ruiXM
叡	ruiYM
铷	ruJ
銣	ruJM
帤	ruJN
褥	ruK
襦	ruKB
袽	ruKM
筎	ruKN
肗	ruLM
如	ruN
润	runE
潤	runEM
橍	runIM
膶	runLM
闰	runM
鳰	ruNML
閏	runMM
閠	runMN
瞤	runMO
媷	ruNN
鴑	ruNO
嬬	ruNP
鴽	ruNQ
嚅	ruO
挼	ruoAM
捼	ruoAN
撋	ruoAO
渃	ruoEM
鄀	ruoFM
弱	ruoG
焫	ruoHM
爇	ruoHN
楉	ruoIM
箬	ruoK
篛	ruoKM
吺	ruOM
嗕	ruON
婼	ruoNM
鶸	ruoNN
嵶	ruoSM
若	ruoU
蒻	ruoUM
偌	ruoV
叒	ruoYM
鰙	ruoYN
鰯	ruoYO
獳	ruQM
醹	ruQN
入	ruR
曘	ruRM
嶿	ruSM
茹	ruU
蓐	ruUB
薷	ruUC
蒘	ruUM
蕠	ruUN
乳	ruV
儒	ruVB
侞	ruVM
颥	ruY
顬	ruYM
鱬	ruYN
孺	ruZ
込	ruZM
撒	saA
挲	saAB
挱	saAM
摋	saAN
攃	saAO
洒	saE
灑	saEM
泧	saEN
潵	saEO
飒	saF
颯	saFM
隡	saFN
纚	saFO
靸	saGM
鞈	saGN
卅	saH
揌	saiAM
赛	saiB
賽	saiBM
簺	saiKM
腮	saiL
櫒	saIM
毢	saiMM
毸	saiMN
噻	saiO
嗮	saiOM
嘥	saiON
塞	saiT
僿	saiVM
愢	saiXM
鳃	saiY
鰓	saiYM
顋	saiYN
钑	saJM
鈒	saJN
鏾	saJO
脎	saL
馺	saMM
鬖	sanBM
氵	sanE
潵	sanEM
繖	sanFM
搡	sangA
桑	sangI
桒	sangIM
槡	sangIN
鎟	sangJM
褬	sangKM
嗓	sangO
磉	sangP
丧	sangS
喪	sangSM
颡	sangY
顙	sangYM
三	sanH
帴	sanJM
厁	sanJN
鏒	sanJO
鏾	sanJP
糁	sanM
毵	sanMB
毿	sanMM
糝	sanMN
閐	sanMO
毶	sanMP
糂	sanMQ
糤	sanMR
糣	sanMS
犙	sanNM
叁	sanS
馓	sanSB
彡	sanSC
參	sanSM
饊	sanSN
壭	sanSO
叄	sanSP
叅	sanSQ
伞	sanV
仨	sanVB
傘	sanVM
仐	sanVN
俕	sanVO
散	sanW
弎	sanYM
扫	saoA
搔	saoAB
掃	saoAM
掻	saoAN
瘙	saoB
螦	saoCM
溞	saoEM
缫	saoF
缲	saoFB
繅	saoFM
繰	saoFN
鄵	saoFO
颾	saoFP
髞	saoGM
鐰	saoJM
臊	saoL
骚	saoM
騷	saoMM
氉	saoMN
騒	saoMO
矂	saoMP
嫂	saoN
埽	saoT
慅	saoXM
懆	saoXN
鳋	saoY
鰠	saoYM
鱢	saoYN
萨	saU
薩	saUM
蕯	saUN
仨	saV
訯	saYM
躠	saZM
拺	seAM
摵	seAN
擌	seAO
瘷	seBM
轖	seCM
涩	seE
澀	seEM
洓	seEN
渋	seEO
澁	seEP
濏	seEQ
濇	seER
瀒	seES
繬	seFM
飋	seFN
廧	seGM
穑	seH
穡	seHM
穯	seHN
栜	seIM
铯	seJ
鉍	seJM
銫	seJN
鎍	seJO
鏼	seJP
粣	seMM
閪	seMN
闟	seMO
鬙	sengBM
僧	sengV
森	senI
椮	senIM
槮	senIN
襂	senKM
嗇	seOM
雭	seRM
色	seS
啬	seSB
塞	seT
薔	seUM
僿	seVM
瑟	seW
琗	seWM
璱	seWN
懎	seXM
譅	seYM
鱪	seYN
歮	seZM
歰	seZN
挲	shaA
挱	shaAM
摋	shaAN
痧	shaB
髿	shaBM
厦	shaC
刹	shaD
剎	shaDM
沙	shaE
濈	shaEM
纱	shaF
紗	shaFM
繌	shaFN
繺	shaFO
廈	shaGM
煞	shaH
杀	shaI
摋	shaiAM
攦	shaiAN
杉	shaIB
繺	shaiFM
骰	shaiG
筛	shaiK
篩	shaiKM
簁	shaiKN
簛	shaiKO
籭	shaiKP
桬	shaIM
閷	shaiMM
榝	shaIN
樧	shaIO
酾	shaiQ
釃	shaiQM
晒	shaiR
曬	shaiRM
色	shaiS
諰	shaiYM
铩	shaJ
鎩	shaJM
帹	shaJN
裟	shaK
箑	shaKM
粆	shaMM
閯	shaMN
閷	shaMO
擅	shanA
掸	shanAB
摻	shanAM
撣	shanAN
攙	shanAO
挻	shanAP
掞	shanAQ
搧	shanAR
赡	shanB
单	shanBB
疝	shanBC
髟	shanBD
贍	shanBM
痁	shanBN
蟮	shanC
軕	shanCM
蟺	shanCN
删	shanD
剡	shanDB
刪	shanDM
剼	shanDN
汕	shanE
潸	shanEB
澘	shanEM
潬	shanEN
灗	shanEO
陕	shanF
缮	shanFB
鄯	shanFC
繕	shanFM
邖	shanFN
陝	shanFO
縿	shanFP
纔	shanFQ
赏	shangB
賞	shangBM
贘	shangBN
螪	shangCM
蠰	shangCN
殇	shangD
殤	shangDM
汤	shangE
泷	shangEB
湯	shangEM
漡	shangEN
滳	shangEO
绱	shangF
緔	shangFM
鞝	shangGM
鬺	shangGN
上	shangH
熵	shangHB
丄	shangHM
扄	shangHN
樉	shangIM
觞	shangJ
觴	shangJM
鋿	shangJN
鏛	shangJO
鑜	shangJP
裳	shangK
商	shangO
晌	shangR
禓	shangSM
墒	shangT
垧	shangTB
埫	shangTM
塲	shangTN
蔏	shangUM
伤	shangV
傷	shangVM
仩	shangVN
尚	shangX
尙	shangXM
恦	shangXN
愓	shangXO
慯	shangXP
謪	shangYM
扇	shanH
煽	shanHB
炶	shanHM
煔	shanHN
熌	shanHO
穇	shanHP
杉	shanI
栅	shanIB
柵	shanIM
杣	shanIN
椫	shanIO
樿	shanIP
檆	shanIQ
钐	shanJ
釤	shanJM
銏	shanJN
幓	shanJO
覢	shanJP
鐥	shanJQ
衫	shanK
笘	shanKM
襂	shanKN
膳	shanL
膻	shanLB
脠	shanLM
闪	shanM
骟	shanMB
閃	shanMM
騸	shanMN
閄	shanMO
閊	shanMP
睒	shanMQ
姗	shanN
嬗	shanNB
姍	shanNM
善	shanO
單	shanOM
嘇	shanON
磰	shanPM
狦	shanQM
猭	shanQN
歚	shanQO
晱	shanRM
山	shanS
禅	shanSB
彡	shanSC
禪	shanSM
単	shanSN
嶦	shanSO
饍	shanSP
埏	shanT
圸	shanTM
墠	shanTN
墡	shanTO
苫	shanU
芟	shanUB
蔪	shanUM
傓	shanVM
僤	shanVN
僐	shanVO
儃	shanVP
珊	shanW
敾	shanWM
讪	shanY
鳝	shanYB
訕	shanYM
鱔	shanYN
鯅	shanYO
謆	shanYP
羴	shanYQ
羶	shanYR
譱	shanYS
鳣	shanYT
鱓	shanYU
鱣	shanYV
跚	shanZ
舢	shanZB
赸	shanZM
啥	shaO
捎	shaoA
勺	shaoB
嗄	shaOBL
髾	shaoBM
蛸	shaoC
唼	shaOCL
輎	shaoCM
潲	shaoE
绍	shaoF
邵	shaoFB
紹	shaoFM
旓	shaoFN
綤	shaoFO
鞘	shaoG
弰	shaoGM
烧	shaoH
稍	shaoHB
燒	shaoHM
焼	shaoHN
梢	shaoI
杓	shaoIB
柖	shaoIM
卲	shaoJM
筲	shaoK
袑	shaoKM
劭	shaoL
唦	shaOM
睄	shaoMM
啑	shaON
娋	shaoNM
哨	shaoO
召	shaoOB
喢	shaOOL
芍	shaoU
苕	shaoUB
莦	shaoUM
萷	shaoUN
蕱	shaoUO
佋	shaoVM
玿	shaoWM
少	shaoX
韶	shaoY
鮹	shaoYM
艄	shaoZ
砂	shaP
殺	shaPM
硰	shaPN
歃	shaQ
猀	shaQM
霎	shaR
莎	shaU
萐	shaUM
菨	shaUN
蔱	shaUO
傻	shaV
乷	shaVM
倽	shaVN
儍	shaVO
鲨	shaY
鯊	shaYM
翜	shaYN
翣	shaYO
魦	shaYP
鯋	shaYQ
歰	shaZM
摄	sheA
折	sheAB
揲	sheAC
攝	sheAM
挕	sheAN
捨	sheAO
摂	sheAP
赊	sheB
賒	sheBM
賖	sheBN
蛇	sheC
赦	sheCB
厍	sheCC
厙	sheCM
虵	sheCN
蛥	sheCO
輋	sheCP
蠂	sheCQ
奢	sheD
奓	sheDM
涉	sheE
滠	sheEB
灄	sheEM
泏	sheEN
渉	sheEO
涻	sheEP
弽	sheGM
檨	sheIM
欇	sheIN
谁	sheiY
誰	sheiYM
麝	sheL
阇	sheMM
闍	sheMN
騇	sheMO
扟	shenAM
抌	shenAN
搷	shenAO
审	shenB
審	shenBM
瘆	shenBN
瘮	shenBO
蜃	shenC
蜄	shenCM
深	shenE
沈	shenEB
渗	shenEC
渖	shenED
滲	shenEM
瀋	shenEN
涁	shenEO
淰	shenEP
兟	shenEQ
绅	shenF
紳	shenFM
邥	shenFN
綝	shenFO
貹	shengBM
賸	shengBN
剩	shengD
斘	shengDM
殅	shengDN
剰	shengDO
渑	shengE
澠	shengEM
泩	shengEN
渻	shengEO
湦	shengEP
绳	shengF
聖	shengFM
聲	shengFN
繩	shengFO
阩	shengFP
陞	shengFQ
陹	shengFR
縄	shengFS
繉	shengFT
焺	shengHM
枡	shengIM
栍	shengIN
椉	shengIO
榺	shengIP
橳	shengIQ
鉎	shengJM
鍟	shengJN
笙	shengK
胜	shengL
勝	shengLM
竔	shengLN
省	shengM
盛	shengMB
眚	shengMC
弞	shenGML
牲	shengN
矤	shenGNL
娍	shengNM
鵿	shengNN
呏	shengOM
升	shengP
乘	shengPB
乗	shengPM
殸	shengPN
狌	shengQM
晟	shengR
昇	shengRM
晠	shengRN
曻	shengRO
生	shengS
声	shengSB
甥	shengSC
嵊	shengSD
鼪	shengSM
圣	shengT
墭	shengTM
苼	shengUM
蕂	shengUN
偗	shengVM
珄	shengWM
琞	shengWN
憴	shengXM
譝	shengYM
甚	shenH
燊	shenHM
黮	shenHN
椹	shenI
罙	shenIM
柛	shenIN
棯	shenIO
榊	shenIP
槮	shenIQ
鉮	shenJM
幓	shenJN
鋠	shenJO
覾	shenJP
裑	shenKM
申	shenL
肾	shenLB
胂	shenLC
腎	shenLM
脤	shenLN
糁	shenM
糝	shenMM
籶	shenMN
冞	shenMO
籸	shenMP
眘	shenMQ
眒	shenMR
糂	shenMS
駪	shenMT
瞫	shenMU
糣	shenMV
婶	shenN
娠	shenNB
嬸	shenNM
妽	shenNN
姺	shenNO
嫀	shenNP
鵢	shenNQ
呻	shenO
哂	shenOB
砷	shenP
氠	shenQM
昚	shenRM
曋	shenRN
曑	shenRO
身	shenS
神	shenSB
参	shenSC
矧	shenSD
參	shenSM
屾	shenSN
峷	shenSO
甡	shenSP
祳	shenSQ
叄	shenSR
叅	shenSS
罧	shenST
甧	shenSU
堔	shenTM
莘	shenU
葚	shenUB
葠	shenUM
蓡	shenUN
蔘	shenUO
薓	shenUP
什	shenV
伸	shenVB
伔	shenVM
侁	shenVN
侺	shenVO
珅	shenWM
敒	shenWN
慎	shenX
穼	shenXM
愼	shenXN
诜	shenY
谂	shenYB
詵	shenYM
諗	shenYN
谉	shenYO
訠	shenYP
訷	shenYQ
頣	shenYR
魫	shenYS
鲹	shenYT
鯓	shenYU
鯵	shenYV
鰰	shenYW
鰺	shenYX
讅	shenYY
磼	shePM
猞	sheQ
歙	sheQB
射	sheS
社	sheSB
舌	sheSC
畲	sheT
畬	sheTM
畭	sheTN
蔎	sheUM
舍	sheV
佘	sheVB
舎	sheVM
韘	sheWM
慑	sheX
懾	sheXM
慴	sheXN
设	sheY
設	sheYM
拾	shiA
拭	shiAB
揓	shiAM
实	shiB
室	shiBB
匙	shiBC
贳	shiBD
實	shiBM
貰	shiBN
実	shiBO
宩	shiBP
宲	shiBQ
痑	shiBR
寔	shiBS
释	shiC
蚀	shiCB
轼	shiCC
虱	shiCD
螫	shiCE
蝕	shiCM
釋	shiCN
軾	shiCO
厔	shiCP
釈	shiCQ
徥	shiCR
蝨	shiCS
失	shiD
殖	shiDB
奭	shiDM
湿	shiE
澤	shiEM
濕	shiEN
兘	shiEO
浉	shiEP
湜	shiEQ
湤	shiER
溼	shiES
溡	shiET
溮	shiEU
澨	shiEV
施	shiF
邿	shiFM
絁	shiFN
事	shiH
世	shiHB
炻	shiHC
丆	shiHM
丗	shiHN
亊	shiHO
戺	shiHP
烒	shiHQ
秲	shiHR
煶	shiHS
柿	shiI
柹	shiIM
枾	shiIN
栻	shiIO
楴	shiIP
榁	shiIQ
榯	shiIR
檡	shiIS
市	shiJ
视	shiJB
师	shiJC
铈	shiJD
師	shiJM
視	shiJN
鈰	shiJO
鎩	shiJP
釶	shiJQ
觢	shiJR
鉐	shiJS
鉂	shiJT
鉃	shiJU
鉇	shiJV
鉽	shiJW
銴	shiJX
鍉	shiJY
鍦	shiJZ
筮	shiK
兙	shiKM
笶	shiKN
篒	shiKO
箷	shiKP
褷	shiKQ
簭	shiKR
籂	shiKS
襫	shiKT
襹	shiKU
势	shiL
勢	shiLM
竍	shiLN
驶	shiM
駛	shiMM
眂	shiMN
冟	shiMO
眎	shiMP
眡	shiMQ
睗	shiMR
馶	shiMS
始	shiN
鸤	shiNM
姼	shiNN
鳲	shiNO
鳾	shiNP
嬕	shiNQ
鶳	shiNR
史	shiO
噬	shiOB
嘘	shiOC
嗜	shiOD
噓	shiOM
呩	shiON
呞	shiOO
咶	shiOP
啫	shiOQ
石	shiP
尸	shiPB
屎	shiPC
屍	shiPM
碩	shiPN
狮	shiQ
酾	shiQB
獅	shiQM
釃	shiQN
狧	shiQO
狶	shiQP
醳	shiQQ
是	shiR
时	shiRB
時	shiRM
旹	shiRN
昰	shiRO
十	shiS
士	shiSB
示	shiSC
食	shiSD
氏	shiSE
饰	shiSF
矢	shiSG
峙	shiSH
舐	shiSI
豕	shiSJ
饣	shiSK
礻	shiSL
飾	shiSM
飭	shiSN
卋	shiSO
飠	shiSP
峕	shiSQ
祏	shiSR
崼	shiSS
崻	shiST
嵵	shiSU
舓	shiSV
餝	shiSW
餙	shiSX
鼫	shiSY
鼭	shiSZ
埘	shiT
塒	shiTM
埶	shiTN
畤	shiTO
莳	shiU
蓍	shiUB
蒔	shiUM
葹	shiUN
蒒	shiUO
使	shiV
似	shiVB
侍	shiVC
仕	shiVD
什	shiVE
乭	shiVM
乨	shiVN
佦	shiVO
瓧	shiWM
瑡	shiWN
恃	shiX
忕	shiXM
忯	shiXN
恀	shiXO
惿	shiXP
试	shiY
式	shiYB
识	shiYC
诗	shiYD
誓	shiYE
弑	shiYF
谥	shiYG
鲥	shiYH
鲺	shiYI
試	shiYM
詩	shiYN
識	shiYO
弒	shiYP
謚	shiYQ
鯴	shiYR
鰣	shiYS
鮖	shiYT
諟	shiYU
諡	shiYV
鰘	shiYW
鰤	shiYX
适	shiZ
逝	shiZB
適	shiZM
辻	shiZN
遈	shiZO
遰	shiZP
遾	shiZQ
手	shouA
授	shouAB
扌	shouAC
守	shouB
兽	shouBB
瘦	shouBC
痩	shouBM
寿	shouC
涭	shouEM
绶	shouF
綬	shouFM
熟	shouH
鏉	shouJM
膄	shouLM
售	shouO
嘼	shouOM
狩	shouQ
獸	shouQM
獣	shouQN
首	shouS
壽	shouSM
夀	shouSN
垨	shouTM
乺	shouVM
收	shouW
敊	shouWM
受	shouY
収	shouYM
艏	shouZ
抒	shuA
摅	shuAB
蜀	shuaC
刷	shuaD
耍	shuaE
摔	shuaiA
蟀	shuaiC
缞	shuaiFM
縗	shuaiFN
帅	shuaiJ
帥	shuaiJM
衰	shuaiK
卛	shuaiSM
率	shuaiX
甩	shuaiY
攄	shuAM
捒	shuAN
拴	shuanA
涮	shuanE
絟	shuanFM
爽	shuangD
泷	shuangE
瀧	shuangEM
滝	shuangEN
漺	shuangEO
灀	shuangEP
縔	shuangFM
樉	shuangIM
欆	shuangIN
鏯	shuangJM
骦	shuangMM
騻	shuangMN
驦	shuangMO
孀	shuangN
孇	shuangNM
鷞	shuangNN
鹴	shuangNO
鸘	shuangNP
礵	shuangPM
霜	shuangR
塽	shuangTM
慡	shuangXM
双	shuangY
雙	shuangZM
艭	shuangZN
栓	shuanI
槫	shuanIM
腨	shuanLM
闩	shuanM
閂	shuanMM
唰	shuaO
捈	shuAOL
掓	shuAP
誜	shuaYM
赎	shuB
贖	shuBM
癙	shuBN
输	shuC
蜀	shuCB
術	shuCM
輸	shuCN
軗	shuCO
尌	shuCP
蠴	shuCQ
殊	shuD
豎	shuDM
鼡	shuDN
淑	shuE
漱	shuEB
沐	shuEC
澍	shuED
沭	shuEE
潄	shuEM
潻	shuEN
濖	shuEO
瀭	shuEP
纾	shuF
紓	shuFM
陎	shuFN
鄃	shuFO
隃	shuFP
絉	shuFQ
綀	shuFR
緰	shuFS
庶	shuG
戍	shuGB
庻	shuGM
熟	shuH
黍	shuHB
秫	shuHC
焂	shuHM
稌	shuHN
虪	shuHO
术	shuI
挩	shuiAM
捝	shuiAN
树	shuIB
束	shuIC
梳	shuID
水	shuiE
氵	shuiEB
枢	shuIEL
氺	shuiEM
涗	shuiEN
涚	shuiEO
税	shuiH
稅	shuiHM
帨	shuiJM
裞	shuiKM
脽	shuiLM
睡	shuiM
樞	shuIML
閖	shuiMM
樹	shuIN
娷	shuiNM
朮	shuIO
杸	shuIP
橾	shuIQ
祱	shuiSM
谁	shuiY
说	shuiYB
誰	shuiYM
說	shuiYN
説	shuiYO
鉥	shuJM
錰	shuJN
鏣	shuJO
裋	shuKM
襡	shuKN
襩	shuKO
籔	shuKP
竖	shuL
丨	shuLB
腧	shuLC
竪	shuLM
毹	shuM
毺	shuMM
氀	shuMN
糬	shuMO
姝	shuN
鬊	shunBM
巛	shunC
輴	shunCM
楯	shunIM
橓	shunIN
瞬	shunM
婌	shuNML
眴	shunMM
瞚	shunMN
瞤	shunMO
鶐	shuNN
吮	shunO
鵨	shuNOL
蕣	shunUM
顺	shunY
順	shunYM
舜	shunZ
搠	shuoA
洬	shuoEM
烁	shuoH
爍	shuoHM
槊	shuoI
铄	shuoJ
鑠	shuoJM
銏	shuoJN
鎙	shuoJO
箾	shuoKM
朔	shuoL
咰	shuOM
矟	shuoMM
妁	shuoN
硕	shuoP
碩	shuoPM
欶	shuoQM
獡	shuoQN
蒴	shuoU
数	shuoW
數	shuoWM
愬	shuoXM
说	shuoY
說	shuoYM
説	shuoYN
属	shuP
殳	shuPB
屬	shuPM
暑	shuR
曙	shuRB
書	shuRM
兪	shuRN
暏	shuRO
霔	shuRP
鼠	shuS
署	shuSB
墅	shuT
塾	shuTB
蔬	shuU
薯	shuUB
菽	shuUC
荗	shuUM
蒁	shuUN
蒣	shuUO
薥	shuUP
藷	shuUQ
书	shuV
舒	shuVB
俞	shuVC
倏	shuVD
侸	shuVM
倐	shuVN
儵	shuVO
数	shuW
數	shuWM
琡	shuWN
瑹	shuWO
璹	shuWP
恕	shuX
尗	shuXM
忬	shuXN
怸	shuXO
怷	shuXP
悆	shuXQ
叔	shuY
鮛	shuYM
鱰	shuYN
述	shuZ
疏	shuZB
孰	shuZC
疋	shuZD
疎	shuZM
踈	shuZN
跾	shuZO
撕	siA
凘	siBM
寺	siC
厮	siCB
蛳	siCC
螄	siCM
厠	siCN
蜤	siCO
蟴	siCP
蟖	siCQ
死	siD
汜	siE
泗	siEB
兕	siEC
澌	siED
亖	siEM
泤	siEN
泀	siEO
洠	siEP
洍	siEQ
涘	siER
瀃	siES
糸	siF
缌	siFB
纟	siFC
絲	siFM
緦	siFN
糹	siFO
飔	siFP
颸	siFQ
廝	siGM
丝	siH
私	siHB
虒	siHM
燍	siHN
杫	siIM
柶	siIN
枱	siIO
梩	siIP
楒	siIQ
榹	siIR
斯	siJ
锶	siJB
鍶	siJM
釲	siJN
覗	siJO
鈻	siJP
鉰	siJQ
鈶	siJR
銉	siJS
銯	siJT
鋖	siJU
鐁	siJV
笥	siK
簛	siKM
耜	siL
耛	siLM
竢	siLN
驷	siM
駟	siMM
騃	siMN
騦	siMO
姒	siN
鸶	siNB
鷥	siNM
牭	siNN
娰	siNO
媤	siNP
司	siO
嘶	siOB
嗣	siOC
咝	siOD
噝	siOM
磃	siPM
饲	siS
祀	siSB
巳	siSC
食	siSD
厶	siSE
飼	siSM
飴	siSN
厼	siSO
飤	siSP
禗	siSQ
罳	siSR
禠	siSS
禩	siST
鼶	siSU
蕬	siUM
蕼	siUN
似	siV
伺	siVB
俟	siVC
佀	siVM
価	siVN
俬	siVO
偲	siVP
傂	siVQ
儩	siVR
四	siW
思	siX
恖	siXM
愢	siXN
肆	siY
肂	siYM
鯣	siYN
孠	siZM
貄	siZN
捒	songAM
揔	songAN
摗	songAO
宋	songB
凇	songBB
鬆	songBM
蜙	songCM
淞	songE
漎	songEM
濍	songEN
耸	songF
聳	songFM
庺	songGM
松	songI
枩	songIM
枀	songIN
柗	songIO
梥	songIP
棇	songIQ
楤	songIR
檧	songIS
鍶	songJM
鎹	songJN
竦	songL
駷	songMM
娀	songNM
吅	songOM
硹	songPM
嵩	songS
崧	songSB
嵷	songSM
餸	songSN
菘	songU
蘴	songUM
倯	songVM
傱	songVN
悚	songX
怂	songXB
忪	songXC
慫	songXM
愡	songXN
愯	songXO
憁	songXP
憽	songXQ
颂	songY
诵	songYB
讼	songYC
訟	songYM
頌	songYN
誦	songYO
送	songZ
搜	souA
擞	souAB
擻	souAM
捒	souAN
捜	souAO
摉	souAP
摗	souAQ
撨	souAR
凁	souBM
瘶	souBN
螋	souC
溲	souE
飕	souF
颼	souFM
鄋	souFN
颾	souFO
廋	souGM
廀	souGN
棷	souIM
櫢	souIN
锼	souJ
鎪	souJM
鏉	souJN
籔	souKM
瞍	souM
騪	souMM
嗽	souO
嗖	souOB
嗾	souOC
欶	souQM
獀	souQN
醙	souQO
馊	souS
餿	souSM
薮	souU
藪	souUM
蓃	souUN
蒐	souUO
傁	souVM
叟	souY
叜	souYM
艘	souZ
摵	suAM
痠	suanBM
匴	suanFM
算	suanK
笇	suanKM
筭	suanKN
篹	suanKO
酸	suanQ
狻	suanQB
祘	suanSM
蒜	suanU
宿	suB
殐	suDM
溯	suE
涑	suEB
泝	suEM
洬	suEN
溸	suEO
潥	suEP
潚	suEQ
素	suF
缩	suFB
縮	suFM
縤	suFN
穌	suHM
稡	suHN
挼	suiAM
賥	suiBM
虽	suiC
濉	suiE
亗	suiEM
浽	suiEN
滖	suiEO
澻	suiEP
瀡	suiEQ
随	suiF
隋	suiFB
隧	suiFC
绥	suiFD
綏	suiFM
隨	suiFN
陏	suiFO
缞	suiFP
縗	suiFQ
繀	suiFR
旞	suiFS
繐	suiFT
繸	suiFU
髓	suiG
鞖	suiGM
髄	suiGN
穗	suiH
燧	suiHB
煫	suiHM
穂	suiHN
熣	suiHO
穟	suiHP
檖	suiIM
鐆	suiJM
鏸	suiJN
鐩	suiJO
襚	suiKM
脺	suiLM
膸	suiLN
睢	suiM
眭	suiMB
梀	suIML
粋	suiMM
睟	suiMN
毸	suiMO
棴	suIN
娞	suiNM
嬘	suiNN
榡	suIO
哸	suiOM
嗺	suiON
碎	suiP
尿	suiPB
樕	suIPL
砕	suiPM
樎	suIQ
橚	suIR
岁	suiS
祟	suiSB
櫯	suISL
嵗	suiSM
禭	suiSN
埣	suiTM
荽	suiU
芕	suiUM
荾	suiUN
倠	suiVM
璲	suiWM
瓍	suiWN
韢	suiWO
谇	suiY
誶	suiYM
譢	suiYN
遂	suiZ
邃	suiZB
歲	suiZM
雖	suiZN
夊	suiZO
遀	suiZP
歳	suiZQ
夙	suJ
觫	suJB
鋉	suJM
簌	suK
膆	suLM
粟	suM
粛	suMM
骕	suMN
驌	suMO
损	sunA
損	sunAM
扻	sunAN
搎	sunAO
摌	sunAP
潠	sunEM
榫	sunI
槂	sunIM
鎨	sunJM
笋	sunK
筍	sunKM
箰	sunKN
簨	sunKO
鹔	suNM
嫊	suNN
鶽	sunNM
鷫	suNO
喰	sunOM
狲	sunQ
猻	sunQM
飧	sunS
飱	sunSM
荪	sunU
蓀	sunUM
蕵	sunUN
薞	sunUO
孙	sunZ
隼	sunZB
孫	sunZM
嗉	suO
挲	suoA
挱	suoAM
摍	suoAN
蜶	suoCM
溹	suoEM
溑	suoEN
索	suoF
缩	suoFB
縮	suoFM
縒	suoFN
所	suoH
梭	suoI
桫	suoIB
锁	suoJ
鎖	suoJM
鎈	suoJN
鎍	suoJO
鎻	suoJP
鏁	suoJQ
褨	suoKM
簑	suoKN
簔	suoKO
睃	suoM
囌	suOML
娑	suoN
嫅	suoNM
嗦	suoO
唆	suoOB
唢	suoOC
嗍	suoOD
嗩	suoOM
獕	suoQM
暛	suoRM
靃	suoRN
蓑	suoU
莎	suoUB
莏	suoUM
葰	suoUN
傞	suoVM
琐	suoW
瑣	suoWM
琑	suoWN
璅	suoWO
惢	suoXM
羧	suoY
魦	suoYM
鮻	suoYN
逤	suoZM
趖	suoZN
碿	suPM
酥	suQ
甦	suSM
餗	suSN
塑	suT
圱	suTM
埣	suTN
塐	suTO
苏	suU
蔌	suUB
蘇	suUM
莤	suUN
藗	suUO
蘓	suUP
俗	suV
僳	suVB
傃	suVM
玊	suWM
珟	suWN
璛	suWO
愫	suX
窣	suXM
愬	suXN
憟	suXO
诉	suY
肃	suYB
稣	suYC
谡	suYD
訴	suYM
肅	suYN
謖	suYO
鯂	suYP
鱐	suYQ
速	suZ
遡	suZM
趚	suZN
遬	suZO
蹜	suZP
拓	taA
挞	taAB
撻	taAM
搨	taAN
撘	taAO
它	taB
沓	taE
漯	taEB
溻	taEC
涾	taEM
溚	taEN
澾	taEO
濌	taEP
鞈	taGM
鞜	taGN
鞳	taGO
榻	taI
抬	taiA
擡	taiAM
太	taiD
大	taiDB
夳	taiDM
冭	taiDN
奤	taiDO
泰	taiE
汰	taiEB
汏	taiEM
汱	taiEN
溙	taiEO
邰	taiF
颱	taiFM
炱	taiH
炲	taiHM
燤	taiHN
枱	taiIM
檯	taiIN
钛	taiJ
鈦	taiJM
鈶	taiJN
箈	taiKM
籉	taiKN
胎	taiL
肽	taiLB
骀	taiM
榙	taIML
駘	taiMM
橽	taIN
嬯	taiNM
台	taiO
呔	taiOB
咍	taiOM
酞	taiQ
旲	taiRM
坮	taiTM
苔	taiU
薹	taiUB
菭	taiUM
儓	taiVM
囼	taiWM
珆	taiWN
斄	taiWO
态	taiX
態	taiXM
忕	taiXN
忲	taiXO
鲐	taiY
鮐	taiYM
跆	taiZ
臺	taiZM
孡	taiZN
舦	taiZO
铊	taJ
鉈	taJM
錔	taJN
鎑	taJO
鎉	taJP
褟	taKM
襨	taKN
闼	taM
闥	taMM
粏	taMN
阘	taMO
毾	taMP
闒	taMQ
闟	taMR
她	taN
探	tanA
摊	tanAB
撣	tanAM
攤	tanAN
擹	tanAO
贪	tanB
瘫	tanBB
痰	tanBC
貪	tanBM
癱	tanBN
賧	tanBO
癉	tanBP
痑	tanBQ
潭	tanE
滩	tanEB
澹	tanEC
灘	tanEM
湠	tanEN
潬	tanEO
郯	tanF
緂	tanFM
罈	tanFN
繵	tanFO
罎	tanFP
弹	tanG
搪	tangA
摥	tangAM
攩	tangAN
螳	tangC
螗	tangCB
蝪	tangCM
赯	tangCN
劏	tangDM
汤	tangE
淌	tangEB
溏	tangEC
湯	tangEM
漟	tangEN
漡	tangEO
灙	tangEP
鄌	tangFM
隚	tangFN
鞺	tangGM
鼞	tangGN
烫	tangH
燙	tangHM
煻	tangHN
爣	tangHO
棠	tangI
樘	tangIB
榶	tangIM
橖	tangIN
欓	tangIO
镗	tangJ
帑	tangJB
铴	tangJC
鏜	tangJM
鐋	tangJN
镋	tangJO
鎲	tangJP
鎕	tangJQ
钂	tangJR
篖	tangKM
簜	tangKN
膛	tangL
耥	tangLB
膅	tangLM
糖	tangM
彈	tanGML
閶	tangMM
糃	tangMN
糛	tangMO
闛	tangMP
闣	tangMQ
矘	tangMR
弾	tanGN
鶶	tangNM
唐	tangO
啺	tangOM
嘡	tangON
磄	tangPM
醣	tangQ
曭	tangRM
躺	tangS
嵣	tangSM
禟	tangSN
餹	tangSO
饄	tangSP
堂	tangT
塘	tangTB
坣	tangTM
蓎	tangUM
薚	tangUN
蘯	tangUO
倘	tangV
傥	tangVB
儻	tangVM
伖	tangVN
偒	tangVO
傏	tangVP
瑭	tangW
惝	tangX
愓	tangXM
戃	tangXN
羰	tangY
趟	tangZ
逿	tangZM
踼	tangZN
蹚	tangZO
炭	tanH
燂	tanHM
黮	tanHN
檀	tanI
榃	tanIM
橝	tanIN
钽	tanJ
锬	tanJB
鉭	tanJM
錟	tanJN
袒	tanK
裧	tanKM
襢	tanKN
毯	tanM
牠	taNML
婒	tanNM
叹	tanO
嘆	tanOM
啴	tanON
嗿	tanOO
嘾	tanOP
嘽	tanOQ
碳	tanP
歎	tanQM
醈	tanQN
醓	tanQO
醰	tanQP
昙	tanR
曇	tanRM
暺	tanRN
舑	tanSM
舕	tanSN
餤	tanSO
坦	tanT
坛	tanTB
坍	tanTC
壇	tanTM
埮	tanTN
墰	tanTO
墵	tanTP
壜	tanTQ
菼	tanUM
藫	tanUN
倓	tanVM
傝	tanVN
僋	tanVO
儃	tanVP
璮	tanWM
忐	tanX
覃	tanXB
怹	tanXM
惔	tanXN
憛	tanXO
憳	tanXP
憻	tanXQ
谈	tanY
谭	tanYB
談	tanYM
譚	tanYN
顃	tanYO
譠	tanYP
貚	tanZM
嗒	taO
掏	taoA
抭	taoAM
搯	taoAN
匋	taoBM
蜪	taoCM
轁	taoCN
套	taoD
丶	taoDB
夲	taoDM
夵	taoDN
涛	taoE
滔	taoEB
淘	taoEC
洮	taoED
濤	taoEM
涭	taoEN
陶	taoF
绦	taoFB
绹	taoFM
絛	taoFN
綯	taoFO
縧	taoFP
縚	taoFQ
鼗	taoG
弢	taoGM
鞀	taoGN
鞉	taoGO
鞱	taoGP
焘	taoH
燾	taoHM
桃	taoI
梼	taoIM
槄	taoIN
檮	taoIO
幍	taoJM
錭	taoJN
鋾	taoJO
裪	taoKM
咜	taOM
駣	taoMM
騊	taoMN
嚃	taON
嫍	taoNM
叨	taoO
啕	taoOB
嚺	taOOL
咷	taoOM
醄	taoQM
饕	taoS
祹	taoSM
飸	taoSN
饀	taoSO
萄	taoU
韬	taoW
韜	taoWM
瑫	taoWN
慆	taoXM
讨	taoY
討	taoYM
詜	taoYN
謟	taoYO
逃	taoZ
迯	taoZM
獭	taQ
獺	taQM
狧	taQN
祂	taSM
崉	taSN
禢	taSO
塔	taT
塌	taTB
墖	taTM
荅	taUM
他	taV
侤	taVM
傝	taVN
鳎	taY
鰨	taYM
誻	taYN
鮙	taYO
譶	taYP
踏	taZ
蹋	taZB
遢	taZC
趿	taZD
逹	taZM
遝	taZN
蹹	taZO
躢	taZP
貸	teBM
貣	teBN
蟘	teCM
忒	teiX
铽	teJ
鋱	teJM
脦	teLM
特	teN
疼	tengB
痋	tengBM
螣	tengCM
漛	tengEM
縢	tengFM
鼟	tengGM
熥	tengHM
幐	tengJM
籐	tengKM
籘	tengKN
腾	tengL
滕	tengLB
膯	tengLM
騰	tengMM
駦	tengMN
驣	tengMO
霯	tengRM
藤	tengU
虅	tengUM
儯	tengVM
誊	tengY
謄	tengYM
鰧	tengYN
邆	tengZM
犆	teNM
忑	teX
忒	teXB
慝	teXC
提	tiA
扌	tiAB
挮	tiAM
掦	tiAN
掭	tianA
捵	tianAM
搷	tianAN
兲	tianBM
痶	tianBN
賟	tianBO
天	tianD
殄	tianDB
添	tianE
沺	tianEM
淟	tianEN
湉	tianEO
紾	tianFM
緂	tianFN
甜	tianG
甛	tianGM
黇	tianHM
钿	tianJ
鈿	tianJM
铦	tianJN
觍	tianJO
銛	tianJP
覥	tianJQ
銽	tianJR
錪	tianJS
腆	tianL
胋	tianLM
阗	tianM
靦	tianMM
闐	tianMN
盷	tianMO
睓	tianMP
睼	tianMQ
奵	tianNM
婖	tianNN
鴫	tianNO
鷏	tianNP
鷆	tianNQ
呑	tianOM
唺	tianON
屇	tianPM
碵	tianPN
磌	tianPO
靔	tianQM
酟	tianQN
靝	tianQO
晪	tianRM
舔	tianS
舑	tianSM
餂	tianSN
舚	tianSO
田	tianT
填	tianTB
畋	tianTC
畑	tianTM
畠	tianTN
塡	tianTO
菾	tianUM
佃	tianV
倎	tianVM
琠	tianWM
瑱	tianWN
璳	tianWO
恬	tianX
忝	tianXB
悿	tianXM
窴	tianXN
顚	tianYM
揥	tiAO
挑	tiaoA
髫	tiaoB
宨	tiaoBM
蜩	tiaoC
龆	tiaoCB
齠	tiaoCM
斢	tiaoDM
聎	tiaoFM
絩	tiaoFN
庣	tiaoGM
鞗	tiaoGN
条	tiaoI
條	tiaoIM
朷	tiaoIN
樤	tiaoIO
銚	tiaoJM
覜	tiaoJN
鋚	tiaoJO
鎥	tiaoJP
笤	tiaoK
朓	tiaoLM
脁	tiaoLN
眺	tiaoM
粜	tiaoMB
糶	tiaoMM
嬥	tiaoNM
咷	tiaoOM
旫	tiaoRM
晀	tiaoRN
祧	tiaoS
岧	tiaoSM
岹	tiaoSN
祒	tiaoSO
苕	tiaoU
蓧	tiaoUM
芀	tiaoUN
萔	tiaoUO
蓚	tiaoUP
蓨	tiaoUQ
佻	tiaoV
儵	tiaoVM
窕	tiaoX
恌	tiaoXM
窱	tiaoXN
调	tiaoY
鲦	tiaoYB
調	tiaoYM
鰷	tiaoYN
誂	tiaoYO
鯈	tiaoYP
跳	tiaoZ
迢	tiaoZB
趒	tiaoZM
擿	tiAP
髰	tiBM
鬀	tiBN
鬄	tiBO
厗	tiCM
徥	tiCN
蝭	tiCO
徲	tiCP
剔	tiD
剃	tiDB
奃	tiDM
殢	tiDN
涕	tiE
揲	tieA
贴	tieB
貼	tieBM
蛈	tieCM
聑	tieFM
铁	tieJ
帖	tieJB
鉆	tieJM
鐵	tieJN
鋨	tieJO
鉄	tieJP
銕	tieJQ
鐡	tieJR
洟	tiEM
驖	tieMM
渧	tiEN
鴩	tieNM
漽	tiEO
呫	tieOM
餮	tieS
飻	tieSM
萜	tieU
僣	tieVM
怗	tieXM
惵	tieXN
跕	tieZM
缇	tiF
绨	tiFB
綈	tiFM
緹	tiFN
體	tiGM
骵	tiGN
戻	tiHM
稊	tiHN
梯	tiI
桋	tiIM
楴	tiIN
锑	tiJ
銻	tiJM
鍗	tiJN
裼	tiK
笹	tiKM
褆	tiKN
褅	tiKO
籊	tiKP
眣	tiMM
睼	tiMN
騠	tiMO
鹈	tiN
挺	tingA
厅	tingC
蜓	tingCB
厛	tingCM
蝏	tingCN
汀	tingE
涏	tingEM
渟	tingEN
濎	tingEO
聽	tingFM
邒	tingFN
綎	tingFO
聤	tingFP
聴	tingFQ
聼	tingFR
庭	tingG
廳	tingGM
庁	tingGN
庍	tingGO
鞓	tingGP
廰	tingGQ
烃	tingH
烴	tingHM
烶	tingHN
梃	tingI
桯	tingIM
楟	tingIN
榳	tingIO
铤	tingJ
鋌	tingJM
筳	tingKM
耓	tingLM
脡	tingLN
閮	tingMM
婷	tingN
娗	tingNM
听	tingO
霆	tingR
嵉	tingSM
鼮	tingSN
亭	tingT
町	tingTB
圢	tingTM
甼	tingTN
莛	tingU
葶	tingUB
艼	tingUM
停	tingV
侹	tingVM
侱	tingVN
珽	tingWM
珵	tingWN
忊	tingXM
廷	tingY
颋	tingYM
誔	tingYN
頲	tingYO
諪	tingYP
艇	tingZ
鵜	tiNM
姼	tiNN
媞	tiNO
媂	tiNP
鶗	tiNQ
鶙	tiNR
鷈	tiNS
鷉	tiNT
鷤	tiNU
啼	tiO
嚏	tiOB
啑	tiOM
嗁	tiON
嚔	tiOO
屉	tiP
屜	tiPM
屟	tiPN
碮	tiPO
磃	tiPP
醍	tiQ
歒	tiQM
替	tiR
罤	tiSM
嵜	tiSN
崹	tiSO
躰	tiSP
禔	tiSQ
軆	tiSR
禵	tiSS
荑	tiU
苐	tiUM
蕛	tiUN
薙	tiUO
体	tiV
倜	tiVB
俶	tiVM
偍	tiVN
珶	tiWM
瑅	tiWN
瓋	tiWO
惕	tiX
悌	tiXB
悐	tiXM
惖	tiXN
惿	tiXO
题	tiY
題	tiYM
詆	tiYN
鳀	tiYO
謕	tiYP
鮷	tiYQ
鯷	tiYR
踢	tiZ
蹄	tiZB
逖	tiZC
迖	tiZM
逷	tiZN
遆	tiZO
趧	tiZP
蹏	tiZQ
趯	tiZR
捅	tongA
痛	tongB
痌	tongBM
蚒	tongCM
衕	tongCN
赨	tongCO
潼	tongE
浵	tongEM
湩	tongEN
统	tongF
統	tongFM
絧	tongFN
綂	tongFO
庝	tongGM
炵	tongHM
烔	tongHN
秱	tongHO
熥	tongHP
燑	tongHQ
穜	tongHR
爞	tongHS
桶	tongI
桐	tongIB
樋	tongIM
橦	tongIN
铜	tongJ
銅	tongJM
鉖	tongJN
鉵	tongJO
筒	tongK
筩	tongKM
童	tongL
勭	tongLM
朣	tongLN
膧	tongLO
瞳	tongM
眮	tongMM
粡	tongMN
氃	tongMO
犝	tongNM
同	tongO
嗵	tongOB
哃	tongOM
砼	tongP
硧	tongPM
酮	tongQ
狪	tongQM
獞	tongQN
晍	tongRM
曈	tongRN
彤	tongS
峒	tongSB
峂	tongSM
峝	tongSN
餇	tongSO
垌	tongT
茼	tongU
蓪	tongUM
佟	tongV
侗	tongVB
僮	tongVC
仝	tongVD
偅	tongVM
囲	tongWM
恸	tongX
慟	tongXM
憅	tongXN
詷	tongYM
鲖	tongYN
鮦	tongYO
通	tongZ
投	touA
头	touD
斢	touDM
紏	touFM
緰	touFN
骰	touG
黈	touHM
钭	touJ
鋀	touJM
鍮	touJN
妵	touNM
媮	touNN
婾	touNO
飳	touSM
亠	touT
埱	touTM
蘣	touUM
偷	touV
偸	touVM
敨	touWM
頭	touYM
透	touZ
捈	tuAM
捸	tuAN
抟	tuanA
摶	tuanAM
剸	tuanDM
湍	tuanE
湪	tuanEM
漙	tuanEN
煓	tuanHM
槫	tuanIM
檲	tuanIN
鏄	tuanJM
褖	tuanKM
篿	tuanKN
糰	tuanMM
鷒	tuanNM
鷻	tuanNN
猯	tuanQM
彖	tuanS
疃	tuanT
塼	tuanTM
畽	tuanTN
墥	tuanTO
团	tuanW
團	tuanWM
団	tuanWN
圕	tuanWO
慱	tuanXM
貒	tuanZM
揬	tuAO
摕	tuAP
宊	tuBM
凃	tuBN
痜	tuBO
瘏	tuBP
徒	tuC
兔	tuD
涂	tuE
汢	tuEM
兎	tuEN
涋	tuEO
湥	tuEP
潳	tuEQ
庩	tuGM
廜	tuGN
秃	tuH
禿	tuHM
稌	tuHN
推	tuiA
蜕	tuiC
蛻	tuiCM
聉	tuiFM
隤	tuiFN
弚	tuiGM
骽	tuiGN
魋	tuiGO
煺	tuiH
穨	tuiHM
橔	tuiIM
褪	tuiK
腿	tuiL
梌	tuIM
駾	tuiMM
騩	tuiMN
檡	tuIN
娧	tuiNM
墤	tuiTM
蓷	tuiUM
藬	tuiUN
蘈	tuiUO
俀	tuiVM
侻	tuiVN
僓	tuiVO
忒	tuiX
怢	tuiXM
颓	tuiY
頹	tuiYM
尵	tuiYN
頽	tuiYO
頺	tuiYP
讉	tuiYQ
退	tuiZ
蹆	tuiZM
蹪	tuiZN
钍	tuJ
釷	tuJM
鈯	tuJN
鋀	tuJO
鋵	tuJP
鍎	tuJQ
凸	tuK
筡	tuKM
腯	tuLM
駼	tuMM
軘	tunCM
蛌	tunCN
蜳	tunCO
氽	tunE
涒	tunEM
庉	tunGM
屯	tunH
焞	tunHM
黗	tunHN
錪	tunJM
褪	tunK
臀	tunL
豚	tunLB
朜	tunLM
鵚	tuNM
鵌	tuNN
吞	tunO
鵵	tuNOL
呑	tunOM
啍	tunON
噋	tunOO
鶟	tuNP
鷋	tuNQ
暾	tunR
鷵	tuNRL
旽	tunRM
霕	tunRN
臋	tunRO
饨	tunS
飩	tunSM
豘	tunSN
坉	tunTM
畽	tunTN
芚	tunUM
囤	tunW
瓲	tunWM
忳	tunXM
憞	tunXN
鲀	tunYM
魨	tunYN
吐	tuO
托	tuoA
拖	tuoAB
拓	tuoAC
扡	tuoAM
拕	tuoAN
挩	tuoAO
捝	tuoAP
搨	tuoAQ
撱	tuoAR
魄	tuoB
彵	tuoCM
蟺	tuoCN
沱	tuoE
汑	tuoEM
沰	tuoEN
涶	tuoEO
陀	tuoF
阤	tuoFM
陁	tuoFN
紽	tuoFO
庹	tuoG
椭	tuoI
橐	tuoIB
柁	tuoIC
柝	tuoID
橢	tuoIM
杔	tuoIN
杝	tuoIO
楕	tuoIP
槖	tuoIQ
铊	tuoJ
鉈	tuoJM
鋖	tuoJN
箨	tuoK
籜	tuoKM
袥	tuoKN
袉	tuoKO
脱	tuoL
脫	tuoLM
驼	tuoM
驮	tuoMB
鼍	tuoMC
唋	tuOML
馱	tuoMM
駝	tuoMN
鼉	tuoMO
毤	tuoMP
馲	tuoMQ
毻	tuoMR
駄	tuoMS
駞	tuoMT
騨	tuoMU
驒	tuoMV
驝	tuoMW
妥	tuoN
鸵	tuoNB
啚	tuONL
鴕	tuoNM
媠	tuoNN
嫷	tuoNO
鵎	tuoNP
唾	tuoO
咃	tuoOM
咜	tuoON
啴	tuoOO
嘽	tuoOP
砣	tuoP
乇	tuoPB
砤	tuoPM
碢	tuoPN
酡	tuoQ
狏	tuoQM
饦	tuoSM
岮	tuoSN
飥	tuoSO
嶞	tuoSP
鼧	tuoSQ
坨	tuoT
堶	tuoTM
莌	tuoUM
萚	tuoUN
蘀	tuoUO
佗	tuoV
仛	tuoVM
侂	tuoVN
侻	tuoVO
讬	tuoYM
託	tuoYN
詑	tuoYO
魠	tuoYP
説	tuoYQ
鮀	tuoYR
鮵	tuoYS
鰖	tuoYT
跎	tuoZ
跅	tuoZM
屠	tuP
酴	tuQ
峹	tuSM
嵞	tuSN
嶀	tuSO
鼵	tuSP
土	tuT
堍	tuTB
塗	tuTM
圡	tuTN
堗	tuTO
墿	tuTP
荼	tuU
菟	tuUB
莵	tuUM
葖	tuUN
蒤	tuUO
图	tuW
圖	tuWM
図	tuWN
瑹	tuWO
圗	tuWP
突	tuX
怢	tuXM
悇	tuXN
馟	tuXO
途	tuZ
迌	tuZM
趃	tuZN
跿	tuZO
挖	waA
搲	waAM
攨	waAN
蛙	waC
徍	waCM
洼	waE
溛	waEM
漥	waEN
邷	waFM
聉	waFN
韈	waGM
瀤	waiEM
竵	waiLM
咼	waiOM
喎	waiON
崴	waiS
外	waiX
夞	waiXM
顡	waiYM
歪	waiZ
帓	waJM
袜	waK
襪	waKM
腽	waL
膃	waLM
劸	waLN
鼃	waMM
娃	waN
挽	wanA
抏	wanAM
捖	wanAN
捥	wanAO
掔	wanAP
完	wanB
宛	wanBB
皖	wanBC
娲	waNBL
貦	wanBM
贃	wanBN
贎	wanBO
蜿	wanC
蚖	wanCM
輓	wanCN
輐	wanCO
蟃	wanCP
豌	wanD
剜	wanDB
刓	wanDM
湾	wanE
灣	wanEM
汍	wanEN
涴	wanEO
澫	wanEP
潫	wanEQ
纨	wanF
绾	wanFB
紈	wanFM
綰	wanFN
鄤	wanFO
絻	wanFP
綄	wanFQ
綩	wanFR
弯	wanG
抂	wangAM
尣	wangBM
尩	wangBN
往	wangC
辋	wangCB
輞	wangCM
彺	wangCN
徃	wangCO
徍	wangCP
蚟	wangCQ
蛧	wangCR
蝄	wangCS
汪	wangE
瀇	wangEM
網	wangFM
魍	wangG
枉	wangI
棢	wangIM
望	wangL
朚	wangLM
朢	wangLN
彎	wanGM
盳	wangMM
妄	wangN
旺	wangR
兦	wangRM
暀	wangRN
罒	wangSM
亡	wangT
网	wangTB
罔	wangTC
罓	wangTM
莣	wangUM
菵	wangUN
亾	wangVM
仼	wangVN
王	wangW
尫	wangWM
忘	wangX
惘	wangXB
忹	wangXM
尪	wangYM
誷	wangYN
迋	wangZM
迬	wangZN
万	wanH
烷	wanHB
杤	wanIM
杬	wanIN
梚	wanIO
椀	wanIP
槾	wanIQ
帵	wanJM
鋄	wanJN
鋔	wanJO
錽	wanJP
鋺	wanJQ
鍐	wanJR
鎫	wanJS
笂	wanKM
腕	wanL
脘	wanLB
脕	wanLM
媧	waNM
毌	wanMM
盌	wanMN
睕	wanMO
関	wanMP
瞣	wanMQ
婉	wanN
婠	waNNL
妧	wanNM
婠	wanNN
唍	wanOM
碗	wanP
丸	wanPB
晚	wanR
晥	wanRM
晩	wanRN
晼	wanRO
卐	wanSM
卍	wanSN
岏	wanSO
畹	wanT
埦	wanTM
塆	wanTN
壪	wanTO
蔓	wanU
莞	wanUB
菀	wanUC
芄	wanUD
萬	wanUM
莬	wanUN
萖	wanUO
薍	wanUP
乛	wanVM
倇	wanVN
玩	wanW
琬	wanWB
琓	wanWM
惋	wanX
夘	wanXM
夗	wanXN
忨	wanXO
惌	wanXP
顽	wanY
頑	wanYM
翫	wanYN
踠	wanZM
哇	waO
咼	waOM
咓	waON
唲	waOO
啘	waOP
嗢	waOQ
嗗	waOR
砙	waPM
屲	waSM
畖	waTM
佤	waV
瓦	waW
瓲	waWM
瓾	waWN
韎	waWO
韤	waWP
窪	waXM
穵	waXN
窊	waXO
窐	waXP
鮭	waYM
捤	weiAM
捼	weiAN
揻	weiAO
揋	weiAP
撱	weiAQ
撝	weiAR
痿	weiB
痏	weiBM
寪	weiBN
癓	weiBO
癐	weiBP
微	weiC
尉	weiCB
軎	weiCC
衛	weiCM
厃	weiCN
徫	weiCO
蜲	weiCP
蜼	weiCQ
蝛	weiCR
蝟	weiCS
衞	weiCT
螱	weiCU
轊	weiCV
为	weiD
危	weiDB
渭	weiE
潍	weiEB
洧	weiEC
沩	weiED
涠	weiEE
濰	weiEM
溈	weiEN
潿	weiEO
洈	weiEP
浘	weiEQ
渨	weiER
湋	weiES
溦	weiET
潙	weiEU
濊	weiEV
濻	weiEW
瀢	weiEX
维	weiF
纬	weiFB
隗	weiFC
隈	weiFD
維	weiFM
緯	weiFN
隇	weiFO
鄬	weiFP
縅	weiFQ
緭	weiFR
颹	weiFS
威	weiG
魏	weiGB
骩	weiGM
骪	weiGN
骫	weiGO
廆	weiGP
炜	weiH
煨	weiHB
為	weiHM
煒	weiHN
烓	weiHO
煟	weiHP
熭	weiHQ
燰	weiHR
未	weiI
桅	weiIB
梶	weiIM
楲	weiIN
椳	weiIO
椲	weiIP
欈	weiIQ
卫	weiJ
帷	weiJB
帏	weiJC
幃	weiJM
覣	weiJN
鍡	weiJO
鍏	weiJP
鏏	weiJQ
覹	weiJR
褽	weiKM
胃	weiL
腲	weiLM
闱	weiM
闈	weiMM
瞆	weiMN
瞶	weiMO
矀	weiMP
委	weiN
娓	weiNB
媙	weiNM
媦	weiNN
媁	weiNO
犚	weiNP
犩	weiNQ
味	weiO
唯	weiOB
喂	weiOC
噲	weiOM
唩	weiON
喴	weiOO
喡	weiOP
尾	weiP
硙	weiPM
硊	weiPN
碨	weiPO
磈	weiPP
磑	weiPQ
猥	weiQ
猬	weiQB
猚	weiQM
醀	weiQN
暐	weiRM
霨	weiRN
霺	weiRO
巍	weiS
崴	weiSB
嵬	weiSC
餵	weiSM
巋	weiSN
峗	weiSO
峞	weiSP
崣	weiSQ
嵔	weiSR
嶉	weiSS
罻	weiST
嶶	weiSU
餧	weiSV
饖	weiSW
畏	weiT
圩	weiTB
墛	weiTM
壝	weiTN
亹	weiTO
薇	weiU
蔚	weiUB
萎	weiUC
苇	weiUD
葳	weiUE
葦	weiUM
芛	weiUN
苿	weiUO
荱	weiUP
菋	weiUQ
葨	weiUR
蒍	weiUS
蓶	weiUT
蔿	weiUU
薳	weiUV
藯	weiUW
蘶	weiUX
位	weiV
伟	weiVB
伪	weiVC
偎	weiVD
偽	weiVM
偉	weiVN
僞	weiVO
儰	weiVP
围	weiW
韦	weiWB
玮	weiWC
韪	weiWD
囗	weiWE
韋	weiWM
圍	weiWN
瑋	weiWO
韙	weiWP
囲	weiWQ
琟	weiWR
韑	weiWS
韡	weiWT
瓗	weiWU
斖	weiWV
慰	weiX
惟	weiXB
愄	weiXM
愇	weiXN
懀	weiXO
谓	weiY
诿	weiYB
鲔	weiYC
謂	weiYM
諉	weiYN
鮪	weiYO
叞	weiYP
詴	weiYQ
頠	weiYR
鮇	weiYS
鳂	weiYT
鮠	weiYU
鳚	weiYV
鰄	weiYW
鰃	weiYX
讆	weiYY
讏	weiYZ
违	weiZ
遗	weiZB
逶	weiZC
艉	weiZD
違	weiZM
遺	weiZN
爲	weiZO
趡	weiZP
踓	weiZQ
躗	weiZR
躛	weiZS
抆	wenAM
揾	wenAN
搵	wenAO
瘟	wenB
瘒	wenBM
蚊	wenC
蚉	wenCM
辒	wenCN
輼	wenCO
螡	wenCP
轀	wenCQ
蟁	wenCR
刎	wenD
歾	wenDM
殟	wenDN
温	wenE
汶	wenEB
溫	wenEM
渂	wenEN
纹	wenF
紊	wenFB
紋	wenFM
聞	wenFN
缊	wenFO
絻	wenFP
緼	wenFQ
縕	wenFR
繧	wenFS
攚	wengAM
齆	wengBM
螉	wengCM
奣	wengDM
滃	wengEM
聬	wengFM
罋	wengFN
鎓	wengJM
勜	wengLM
鞰	wenGM
瞈	wengMM
鹟	wengNM
鶲	wengNN
嗡	wengO
暡	wengRM
嵡	wengSM
塕	wengTM
蓊	wengU
蕹	wengUB
瓮	wengW
甕	wengWM
翁	wengY
稳	wenH
穩	wenHM
炆	wenHN
穏	wenHO
桽	wenIM
榅	wenIN
榲	wenIO
鎾	wenJM
肳	wenLM
脕	wenLN
脗	wenLO
问	wenM
闻	wenMB
阌	wenMC
閿	wenMM
駇	wenMN
馼	wenMO
閺	wenMP
闅	wenMQ
闦	wenMR
妏	wenNM
鳼	wenNN
鴍	wenNO
吻	wenO
問	wenOM
呅	wenON
呡	wenOO
雯	wenR
昷	wenRM
彣	wenSM
豱	wenSN
鼤	wenSO
饂	wenSP
亠	wenT
塭	wenTM
蕴	wenU
芠	wenUM
莬	wenUN
蕰	wenUO
伆	wenVM
文	wenW
玟	wenWB
璺	wenWC
攵	wenWD
韞	wenWM
珳	wenWN
瑥	wenWO
忟	wenXM
忞	wenXN
魰	wenYM
鳁	wenYN
顐	wenYO
鰛	wenYP
鰮	wenYQ
夂	wenZ
握	woA
挝	woAB
撾	woAM
捰	woAN
捼	woAO
捾	woAP
擭	woAQ
卧	woB
蜗	woC
龌	woCB
臥	woCM
蝸	woCN
齷	woCO
斡	woD
沃	woE
涡	woEB
渥	woEC
渦	woEM
涹	woEN
涴	woEO
濄	woEP
濣	woEQ
緺	woFM
我	woG
焥	woHM
枂	woIM
楃	woIN
幄	woJ
肟	woL
臒	woLM
腛	woLN
龏	woLO
瞃	woMM
媼	woNM
婐	woNN
婑	woNO
媉	woNP
喔	woO
咼	woOM
唩	woON
硪	woP
猧	woQM
堝	woTM
莴	woU
萵	woUM
薶	woUN
倭	woV
仴	woVM
偓	woVN
瓁	woWM
窝	woX
窩	woXM
馧	woXN
踒	woZM
踠	woZN
雘	woZO
捂	wuA
扜	wuAM
扝	wuAN
扤	wuAO
摀	wuAP
勿	wuB
寤	wuBB
痦	wuBC
鼿	wuBM
齀	wuBN
蜈	wuC
螐	wuCM
蟱	wuCN
剭	wuDM
奦	wuDN
污	wuE
浯	wuEB
汙	wuEM
汚	wuEN
沕	wuEO
洿	wuEP
洖	wuEQ
渞	wuER
溩	wuES
潕	wuET
邬	wuF
於	wuFB
阢	wuFC
鄔	wuFM
郚	wuFN
陚	wuFO
隖	wuFP
巫	wuG
戊	wuGB
庑	wuGC
廡	wuGM
弙	wuGN
靰	wuGO
五	wuH
无	wuHB
焐	wuHC
烏	wuHM
無	wuHN
熓	wuHO
熃	wuHP
梧	wuI
杌	wuIB
杅	wuIM
杇	wuIN
柮	wuIO
橆	wuIP
钨	wuJ
鋈	wuJB
鎢	wuJM
卼	wuJN
釫	wuJO
铻	wuJP
幠	wuJQ
鋙	wuJR
鋘	wuJS
錻	wuJT
箼	wuKM
务	wuL
務	wuLM
膴	wuLN
毋	wuM
骛	wuMB
騖	wuMM
粅	wuMN
瞴	wuMO
物	wuN
妩	wuNB
鹉	wuNC
鹜	wuND
婺	wuNE
牾	wuNF
嫵	wuNM
鵡	wuNN
鶩	wuNO
娪	wuNP
娒	wuNQ
娬	wuNR
鹀	wuNS
鴮	wuNT
鵐	wuNU
鷡	wuNV
吴	wuO
呜	wuOB
吾	wuOC
唔	wuOD
吳	wuOM
嗚	wuON
呉	wuOO
啎	wuOP
屋	wuP
午	wuPB
乌	wuPC
矹	wuPM
碔	wuPN
歍	wuQM
雾	wuR
晤	wuRB
霧	wuRM
旿	wuRN
雺	wuRO
霚	wuRP
霿	wuRQ
鼯	wuS
屼	wuSM
岉	wuSN
峿	wuSO
祦	wuSP
嵍	wuSQ
嵨	wuSR
禑	wuSS
亡	wuT
坞	wuTB
圬	wuTC
塢	wuTM
堥	wuTN
墲	wuTO
芜	wuU
芴	wuUB
蕪	wuUM
莁	wuUN
茣	wuUO
蘁	wuUP
伍	wuV
侮	wuVB
仵	wuVC
乄	wuVM
亾	wuVN
俉	wuVO
倵	wuVP
僫	wuVQ
儛	wuVR
兀	wuW
玝	wuWM
敄	wuWN
珸	wuWO
珷	wuWP
瑦	wuWQ
璑	wuWR
甒	wuWS
舞	wuX
恶	wuXB
悟	wuXC
忤	wuXD
怃	wuXE
惡	wuXM
憮	wuXN
忢	wuXO
悮	wuXP
悞	wuXQ
窏	wuXR
窹	wuXS
误	wuY
诬	wuYB
誣	wuYM
誤	wuYN
誈	wuYO
鯃	wuYP
譕	wuYQ
鰞	wuYR
武	wuZ
迕	wuZB
逜	wuZM
趶	wuZN
躌	wuZO
捾	xiaAM
疜	xiaBM
疨	xiaBN
厦	xiaC
辖	xiaCB
虾	xiaCC
蝦	xiaCM
轄	xiaCN
徦	xiaCO
赮	xiaCP
螛	xiaCQ
夾	xiaDM
浹	xiaEM
匣	xiaF
罅	xiaFB
陜	xiaFM
陿	xiaFN
颬	xiaFO
縖	xiaFP
廈	xiaGM
谺	xiaGN
下	xiaH
黠	xiaHB
煆	xiaHM
丅	xiaHN
炠	xiaHO
烚	xiaHP
柙	xiaI
梺	xiaIM
鍜	xiaJM
鎼	xiaJN
鎋	xiaJO
鏬	xiaJP
笚	xiaKM
筪	xiaKN
瞎	xiaM
扢	xiAML
閕	xiaMM
閜	xiaMN
睱	xiaMO
騢	xiaMP
扱	xiAN
掀	xianA
摻	xianAM
搟	xianAN
挦	xianAO
搚	xianAP
撊	xianAQ
撏	xianAR
攇	xianAS
攕	xianAT
贤	xianB
宪	xianBB
冼	xianBC
痫	xianBD
賢	xianBM
癇	xianBN
癎	xianBO
贒	xianBP
衔	xianC
蚬	xianCB
蜆	xianCM
臤	xianCN
軐	xianCO
蚿	xianCP
蛝	xianCQ
衘	xianCR
輱	xianCS
豏	xianDM
先	xianE
洗	xianEB
涎	xianEC
涀	xianEM
湺	xianEN
溓	xianEO
澖	xianEP
瀗	xianEQ
灦	xianER
线	xianF
险	xianFB
限	xianFC
陷	xianFD
纤	xianFE
險	xianFM
線	xianFN
縣	xianFO
纖	xianFP
陥	xianFQ
険	xianFR
絃	xianFS
缐	xianFT
絤	xianFU
綖	xianFV
綅	xianFW
綫	xianFX
繊	xianFY
纎	xianFZ
弦	xianG
咸	xianGB
厢	xiangC
蟓	xiangCB
蚃	xiangCM
衖	xiangCN
蠁	xiangCO
忀	xiangCP
鬨	xiangDM
湘	xiangE
潒	xiangEM
降	xiangF
缃	xiangFB
鄉	xiangFM
緗	xiangFN
郷	xiangFO
鄊	xiangFP
缿	xiangFQ
鄕	xiangFR
絴	xiangFS
纕	xiangFT
庠	xiangG
廂	xiangGM
相	xiangI
橡	xiangIB
栙	xiangIM
楿	xiangIN
欀	xiangIO
镶	xiangJ
鑲	xiangJM
銄	xiangJN
銗	xiangJO
鐌	xiangJP
箱	xiangK
襐	xiangKM
勨	xiangLM
膷	xiangLN
勷	xiangLO
麘	xiangLP
骧	xiangM
廯	xianGML
驤	xiangMM
閧	xiangMN
闂	xiangMO
闀	xiangMP
韅	xianGN
姠	xiangNM
向	xiangO
响	xiangOB
啍	xiangOM
啌	xiangON
嚮	xiangOO
晑	xiangRM
曏	xiangRN
象	xiangS
祥	xiangSB
巷	xiangSC
饷	xiangSD
飨	xiangSE
餉	xiangSM
饗	xiangSN
嶑	xiangSO
饟	xiangSP
享	xiangT
襄	xiangTB
亯	xiangTM
葙	xiangU
芗	xiangUB
薌	xiangUM
萫	xiangUN
像	xiangV
乡	xiangVB
佭	xiangVM
儴	xiangVN
瓨	xiangWM
珦	xiangWN
瓖	xiangWO
想	xiangX
香	xiangXB
项	xiangY
翔	xiangYB
详	xiangYC
鲞	xiangYD
項	xiangYM
詳	xiangYN
響	xiangYO
鯗	xiangYP
羏	xiangYQ
鮝	xiangYR
鱌	xiangYS
鱜	xiangYT
鱶	xiangYU
夅	xiangZM
跭	xiangZN
燹	xianH
秈	xianHM
烍	xianHN
稴	xianHO
杴	xianIM
枮	xianIN
槏	xianIO
橺	xianIP
橌	xianIQ
櫶	xianIR
见	xianJ
铣	xianJB
锨	xianJC
見	xianJM
銜	xianJN
銑	xianJO
鍁	xianJP
釤	xianJQ
臽	xianJR
铦	xianJS
銛	xianJT
韯	xianJU
鋧	xianJV
銽	xianJW
錎	xianJX
幰	xianJXL
韱	xianJY
鏾	xianJYL
鍌	xianJZ
鑦	xianJZL
筅	xianK
筧	xianKM
箲	xianKN
褼	xianKO
襳	xianKP
腺	xianL
鹹	xianLM
胘	xianLN
臔	xianLO
麙	xianLP
闲	xianM
籼	xianMB
鶷	xiaNML
閑	xianMM
闞	xianMN
盷	xianMO
県	xianMP
毨	xianMQ
睍	xianMR
閒	xianMS
粯	xianMT
瞯	xianMU
麲	xianMV
糮	xianMW
嫌	xianN
娴	xianNB
鹇	xianNC
嫻	xianNM
鷴	xianNN
奾	xianNO
妶	xianNP
姺	xianNQ
姭	xianNR
娊	xianNS
婱	xianNT
娹	xianNU
嫺	xianNV
嬐	xianNW
孅	xianNX
鶱	xianNY
鷼	xianNZ
鷳	xianNZL
咞	xianOM
咁	xianON
唌	xianOO
哯	xianOP
啣	xianOQ
嗛	xianOR
嘕	xianOS
硍	xianPM
礥	xianPN
献	xianQ
酰	xianQB
氙	xianQC
猃	xianQD
獻	xianQM
獫	xianQN
欦	xianQO
狝	xianQP
醎	xianQQ
獮	xianQR
醶	xianQS
玁	xianQT
显	xianR
霰	xianRB
晛	xianRM
县	xianS
馅	xianSB
祆	xianSC
岘	xianSD
彡	xianSE
餡	xianSM
峴	xianSN
禰	xianSO
屳	xianSP
崄	xianSQ
禒	xianSR
嶮	xianSS
鼸	xianST
堿	xianTM
垷	xianTN
埳	xianTO
塪	xianTP
壏	xianTQ
苋	xianU
藓	xianUB
莶	xianUC
莧	xianUM
薟	xianUN
蘞	xianUO
蘚	xianUP
苮	xianUQ
藖	xianUR
仙	xianV
仚	xianVM
佡	xianVN
伭	xianVO
俔	xianVP
僊	xianVQ
僲	xianVR
僴	xianVS
僩	xianVT
现	xianW
現	xianWM
玹	xianWN
珗	xianWO
甉	xianWP
憲	xianXM
慳	xianXN
忺	xianXO
尠	xianXP
尟	xianXQ
憪	xianXR
憸	xianXS
懢	xianXT
馦	xianXU
鲜	xianY
羡	xianYB
羨	xianYM
鮮	xianYN
顯	xianYO
誢	xianYP
誸	xianYQ
羬	xianYR
諴	xianYS
顈	xianYT
顕	xianYU
譀	xianYV
鰔	xianYW
譣	xianYX
鱻	xianYY
舷	xianZ
暹	xianZB
跹	xianZC
跣	xianZD
躚	xianZM
赻	xianZN
蹮	xianZO
吓	xiaO
揱	xiaoAM
撨	xiaoAN
宵	xiaoB
唬	xiaOBL
宯	xiaoBM
痚	xiaoBN
痟	xiaoBO
皛	xiaoBP
皢	xiaoBQ
呷	xiaOC
蛸	xiaoCL
蟏	xiaoCM
蟂	xiaoCN
轇	xiaoCO
蟰	xiaoCP
蠨	xiaoCQ
削	xiaoD
消	xiaoE
潇	xiaoEB
淆	xiaoEC
瀟	xiaoEM
洨	xiaoEN
涍	xiaoEO
漻	xiaoEP
潚	xiaoEQ
绡	xiaoF
綃	xiaoFM
郩	xiaoFN
颵	xiaoFO
縿	xiaoFP
魈	xiaoG
庨	xiaoGM
骹	xiaoGN
彇	xiaoGO
髇	xiaoGP
髐	xiaoGQ
灲	xiaoHM
灱	xiaoHN
烋	xiaoHO
虓	xiaoHP
焇	xiaoHQ
熇	xiaoHR
燆	xiaoHS
穘	xiaoHT
熽	xiaoHU
校	xiaoI
枭	xiaoIB
枵	xiaoIC
梟	xiaoIM
橚	xiaoIN
櫹	xiaoIO
销	xiaoJ
銷	xiaoJM
笑	xiaoK
箫	xiaoKB
筱	xiaoKC
簫	xiaoKM
笹	xiaoKN
筿	xiaoKO
箾	xiaoKP
篠	xiaoKQ
簘	xiaoKR
肖	xiaoL
扸	xiAOLL
効	xiaoLM
膮	xiaoLN
骁	xiaoM
嚇	xiaOML
驍	xiaoMM
睄	xiaoMN
鸮	xiaoNM
婋	xiaoNN
鴞	xiaoNO
鴵	xiaoNP
鷍	xiaoNQ
啸	xiaoO
嚣	xiaoOB
哮	xiaoOC
哓	xiaoOD
嘯	xiaoOM
囂	xiaoON
嘵	xiaoOO
呺	xiaoOP
咲	xiaoOQ
啋	xiaoOR
嗃	xiaoOS
嘋	xiaoOT
嘨	xiaoOU
嘐	xiaoOV
嚻	xiaoOW
硝	xiaoP
硣	xiaoPM
殽	xiaoPN
毊	xiaoPO
猇	xiaoQM
歊	xiaoQN
獟	xiaoQO
獢	xiaoQP
歗	xiaoQQ
晓	xiaoR
霄	xiaoRB
曉	xiaoRM
暁	xiaoRN
崤	xiaoS
萧	xiaoU
蕭	xiaoUM
莦	xiaoUN
萷	xiaoUO
薂	xiaoUP
藃	xiaoUQ
虈	xiaoUR
侾	xiaoVM
俲	xiaoVN
傚	xiaoVO
效	xiaoW
敩	xiaoWM
斅	xiaoWN
斆	xiaoWO
小	xiaoX
恔	xiaoXM
恷	xiaoXN
窙	xiaoXO
憢	xiaoXP
訤	xiaoYM
翛	xiaoYN
詨	xiaoYO
誟	xiaoYP
誵	xiaoYQ
謏	xiaoYR
謞	xiaoYS
謼	xiaoYT
譊	xiaoYU
逍	xiaoZ
孝	xiaoZB
踃	xiaoZM
硖	xiaP
摡	xiAPL
硤	xiaPM
碬	xiaPN
磍	xiaPO
狭	xiaQ
狎	xiaQB
狹	xiaQM
欱	xiaQN
猇	xiaQO
霞	xiaR
暇	xiaRB
昰	xiaRM
峡	xiaS
峽	xiaSM
祫	xiaSN
圷	xiaTM
埉	xiaTN
芐	xiaUM
蕸	xiaUN
侠	xiaV
俠	xiaVM
傄	xiaVN
瑕	xiaW
珨	xiaWM
敮	xiaWN
舝	xiaWO
懗	xiaXM
叚	xiaYM
翈	xiaYN
諕	xiaYO
魻	xiaYP
謑	xiaYQ
鰕	xiaYR
夏	xiaZ
遐	xiaZB
舺	xiaZM
夓	xiaZN
兮	xiB
皙	xiBB
卥	xiBM
瘜	xiBN
凞	xiBO
蜥	xiC
徙	xiCB
蟋	xiCC
螅	xiCD
徆	xiCM
赥	xiCN
赩	xiCO
徯	xiCP
蜤	xiCQ
蝷	xiCR
螇	xiCS
蟢	xiCT
蠵	xiCU
奚	xiD
鬩	xiDM
洗	xiE
携	xieA
挟	xieAB
撷	xieAC
挾	xieAM
攜	xieAN
擷	xieAO
拹	xieAP
揳	xieAQ
搚	xieAR
擕	xieAS
溪	xiEB
寫	xieBM
卨	xieBN
禼	xieBO
齂	xieBP
蝎	xieC
蟹	xieCB
汐	xiECL
蠍	xieCM
徢	xieCN
蝢	xieCO
齘	xieCP
蠏	xieCQ
齛	xieCR
齥	xieCS
斜	xieD
契	xieDB
淅	xiEDL
奊	xieDM
些	xieE
泄	xieEB
泻	xieEC
瀣	xieED
渫	xieEE
浠	xiEEL
瀉	xieEM
洩	xieEN
滊	xieEO
澥	xieEP
邪	xieF
缬	xieFB
绁	xieFC
紲	xieFM
纈	xieFN
缷	xieFO
絜	xieFP
絏	xieFQ
絬	xieFR
綊	xieFS
緳	xieFT
緤	xieFU
縀	xieFV
繲	xieFW
鞋	xieG
廨	xieGB
靾	xieGM
鞢	xieGN
鞵	xieGO
灺	xieHM
炧	xieHN
炨	xieHO
烲	xieHP
焎	xieHQ
熁	xieHR
燲	xieHS
爕	xieHT
械	xieI
榭	xieIB
楔	xieIC
榍	xieID
枻	xieIM
栧	xieIN
梋	xieIO
榝	xieIP
樧	xieIQ
解	xieJ
卸	xieJB
觟	xieJM
觧	xieJN
韰	xieJO
褻	xieKM
衺	xieKN
裌	xieKO
褉	xieKP
襭	xieKQ
胁	xieL
勰	xieLB
脅	xieLM
劦	xieLN
脇	xieLO
脋	xieLP
膎	xieLQ
写	xieM
渓	xiEML
冩	xieMM
糏	xieMN
滊	xiEN
娎	xieNM
媟	xieNN
孈	xieNO
叶	xieO
漇	xiEOL
吤	xieOM
嗋	xieON
噧	xieOO
嚡	xieOP
屑	xieP
漝	xiEPL
屓	xiePM
屟	xiePN
碿	xiePO
屧	xiePP
屭	xiePQ
歇	xieQ
獬	xieQB
澙	xiEQL
猲	xieQM
獦	xieQN
潟	xiER
旪	xieRM
暬	xieRN
协	xieS
潝	xiESL
協	xieSM
祄	xieSN
峫	xieSO
嶰	xieSP
亵	xieT
垥	xieTM
塮	xieTN
薤	xieU
薢	xieUM
藛	xieUN
偕	xieV
伳	xieVM
偰	xieVN
偞	xieVO
僁	xieVP
儶	xieVQ
瑎	xieWM
韘	xieWN
血	xieX
懈	xieXB
恊	xieXM
慀	xieXN
愶	xieXO
谢	xieY
谐	xieYB
颉	xieYC
燮	xieYD
諧	xieYM
謝	xieYN
頡	xieYO
鮭	xieYP
翓	xieYQ
魼	xieYR
讗	xieYS
龤	xieYT
邂	xieZ
蹀	xieZB
躞	xieZC
夑	xieZM
躠	xieZN
系	xiF
细	xiFB
隙	xiFC
郗	xiFD
隰	xiFE
細	xiFM
郤	xiFN
匸	xiFO
邜	xiFP
郋	xiFQ
绤	xiFR
鄎	xiFS
隟	xiFT
綌	xiFU
緆	xiFV
縘	xiFW
隵	xiFWL
縰	xiFX
酅	xiFXL
繥	xiFY
飁	xiFYL
繫	xiFZ
纚	xiFZL
戏	xiG
席	xiGB
戲	xiGM
廗	xiGN
戯	xiGO
戱	xiGP
豀	xiGQ
谿	xiGR
稀	xiH
熙	xiHB
熄	xiHC
熹	xiHD
烯	xiHE
焁	xiHM
焈	xiHN
焟	xiHO
焬	xiHP
煕	xiHQ
稧	xiHR
熈	xiHS
熂	xiHT
黖	xiHU
熺	xiHV
熻	xiHW
燨	xiHX
虩	xiHY
爔	xiHZ
析	xiI
栖	xiIB
檄	xiIC
樨	xiID
棲	xiIM
杫	xiIN
枲	xiIO
桸	xiIP
椞	xiIQ
椺	xiIR
榽	xiIS
槢	xiIT
橲	xiIU
橀	xiIV
希	xiJ
锡	xiJB
舄	xiJC
铣	xiJD
觋	xiJE
銑	xiJM
錫	xiJN
覡	xiJO
钑	xiJP
釳	xiJQ
釸	xiJR
鏭	xiJRL
鈒	xiJS
鐊	xiJSL
舃	xiJT
觹	xiJTL
鈢	xiJU
觽	xiJUL
厀	xiJV
觿	xiJVL
鉩	xiJW
鑴	xiJWL
鉨	xiJX
覤	xiJY
鎴	xiJZ
袭	xiK
裼	xiKB
襲	xiKM
膝	xiL
腊	xiLB
臘	xiLM
肸	xiLN
肹	xiLO
釐	xiLP
阋	xiM
粞	xiMB
盻	xiMM
睎	xiMN
瞦	xiMO
糦	xiMP
騱	xiMQ
闟	xiMR
騽	xiMS
矖	xiMT
驨	xiMU
牺	xiN
撢	xinAM
嬉	xiNB
寻	xinC
媳	xiNCL
軐	xinCM
潃	xinEM
阠	xinFM
邤	xinFN
擤	xingA
兴	xingB
皨	xingBM
行	xingC
巠	xingCM
蛵	xingCN
刑	xingD
滎	xingEM
洐	xingEN
涬	xingEO
邢	xingF
陉	xingFB
陘	xingFM
郉	xingFN
緈	xingFO
煋	xingHM
杏	xingI
興	xingJM
钘	xingJN
铏	xingJO
鈃	xingJP
銒	xingJQ
鉶	xingJR
觪	xingJS
鋞	xingJT
觲	xingJU
裄	xingKM
箵	xingKN
篂	xingKO
腥	xingL
臖	xingLM
省	xingM
庍	xinGML
骍	xingMM
睲	xingMN
騂	xingMO
姓	xingN
廞	xinGNL
娙	xingNM
婞	xingNN
嬹	xingNO
鬵	xinGO
哘	xingOM
硎	xingP
醒	xingQ
猩	xingQB
狌	xingQM
星	xingR
曐	xingRM
形	xingS
饧	xingSB
餳	xingSM
幸	xingT
型	xingTB
坙	xingTM
垶	xingTN
荥	xingU
荇	xingUB
莕	xingUM
葕	xingUN
侀	xingVM
倖	xingVN
瑆	xingWM
性	xingX
惺	xingXB
悻	xingXC
鮏	xingYM
謃	xingYN
鯹	xingYO
炘	xinHM
焮	xinHN
枔	xinIM
杺	xinIN
橝	xinIO
新	xinJ
鑫	xinJB
锌	xinJC
镡	xinJE
鋅	xinJM
鐔	xinJN
鈊	xinJO
舋	xinJP
襑	xinKM
脪	xinLM
犧	xiNM
盺	xinMM
馸	xinMN
娭	xiNN
妡	xinNM
嬜	xinNN
犔	xiNO
噺	xinOM
噷	xinON
囟	xinP
嬆	xiNPL
礥	xinPM
欣	xinQ
歆	xinQB
犠	xiNQL
釁	xinQM
昕	xinR
鵗	xiNRL
鸂	xiNS
薪	xinU
芯	xinUB
莘	xinUC
信	xinV
伩	xinVM
伈	xinVN
俽	xinVO
心	xinX
辛	xinXB
馨	xinXC
衅	xinXD
忻	xinXE
忄	xinXF
惞	xinXM
愖	xinXN
馫	xinXO
訢	xinYM
訫	xinYN
顖	xinYO
孞	xinZM
喜	xiO
吸	xiOB
嘻	xiOC
唏	xiOD
呬	xiOM
咥	xiON
匈	xiongB
匂	xiongBM
賯	xiongBN
赨	xiongCM
兄	xiongE
汹	xiongEB
兇	xiongEM
洶	xiongEN
熊	xiongH
焸	xiongHM
焽	xiongHN
熋	xiongHO
凶	xiongK
胸	xiongL
胷	xiongLM
哅	xiongOM
芎	xiongU
敻	xiongWM
忷	xiongXM
恟	xiongXN
讻	xiongYM
诇	xiongYN
訩	xiongYO
詗	xiongYP
詾	xiongYQ
雄	xiongZ
夐	xiongZM
唽	xiOO
喺	xiOP
噏	xiOQ
嚱	xiOR
囍	xiOS
犀	xiP
矽	xiPB
硒	xiPC
屣	xiPD
屃	xiPM
屓	xiPN
屖	xiPO
碏	xiPP
磎	xiPQ
礂	xiPR
磶	xiPS
屭	xiPT
歙	xiQ
醯	xiQB
欷	xiQC
欪	xiQM
欯	xiQN
氥	xiQO
狶	xiQP
獡	xiQQ
歖	xiQR
晰	xiR
昔	xiRB
曦	xiRC
雭	xiRM
晞	xiRN
晳	xiRO
暿	xiRP
霫	xiRQ
霼	xiRR
禧	xiS
饩	xiSB
禊	xiSC
鼷	xiSD
餼	xiSM
卌	xiSN
饻	xiSO
嵠	xiSP
豨	xiSQ
嶍	xiSR
餏	xiSS
嶲	xiST
豯	xiSU
巂	xiSV
巇	xiSW
鼰	xiSX
饎	xiSY
鼳	xiSZ
塈	xiTM
塜	xiTN
墍	xiTO
壐	xiTP
茜	xiU
宿	xiuB
髹	xiuBB
葸	xiUBL
髤	xiuBM
齅	xiuBN
蓰	xiUC
螑	xiuCM
菥	xiUD
溴	xiuE
滫	xiuEM
潃	xiuEN
绣	xiuF
繡	xiuFM
綉	xiuFN
繍	xiuFO
飍	xiuFP
庥	xiuG
秀	xiuH
烋	xiuHM
烌	xiuHN
朽	xiuI
樇	xiuIM
櫹	xiuIN
锈	xiuJ
銹	xiuJM
銝	xiuJN
鎀	xiuJO
鏅	xiuJP
鏥	xiuJQ
鏽	xiuJR
袖	xiuK
褏	xiuKM
褎	xiuKN
脩	xiuLM
脙	xiuLN
莔	xiUM
糔	xiuMM
鸺	xiuN
莃	xiUNL
鵂	xiuNM
嗅	xiuO
咻	xiuOB
蔇	xiUOL
嚊	xiuOM
葈	xiUP
蒨	xiUQ
蒠	xiUR
岫	xiuS
馐	xiuSB
蒵	xiUSL
饈	xiuSM
峀	xiuSN
蓆	xiUT
蕮	xiUU
苬	xiuUM
茠	xiuUN
修	xiuV
休	xiuVB
薂	xiUVL
俢	xiuVM
珛	xiuWM
琇	xiuWN
璓	xiuWO
羞	xiuY
鮴	xiuYM
鱃	xiuYN
臭	xiuZ
貅	xiuZB
臹	xiuZM
习	xiV
僖	xiVB
俙	xiVM
係	xiVN
傒	xiVO
玺	xiW
璽	xiWM
琋	xiWN
瓕	xiWO
西	xiX
息	xiXB
惜	xiXC
悉	xiXD
夕	xiXE
穸	xiXF
愾	xiXM
忚	xiXN
忥	xiXO
怬	xiXP
怸	xiXQ
恄	xiXR
恓	xiXS
悕	xiXT
惁	xiXU
慀	xiXV
憘	xiXW
憙	xiXX
窸	xiXY
衋	xiXZ
羲	xiY
翕	xiYB
習	xiYM
鰓	xiYN
誒	xiYO
羛	xiYP
翖	xiYQ
諰	xiYR
謑	xiYS
鯑	xiYT
謵	xiYU
鳛	xiYV
譆	xiYW
鰼	xiYX
鱚	xiYY
蹊	xiZ
舾	xiZB
趇	xiZM
趘	xiZN
貕	xiZO
蹝	xiZP
雟	xiZQ
躧	xiZR
掝	xuAM
揟	xuAN
揎	xuanA
揈	xuanAM
宣	xuanB
癣	xuanBB
痃	xuanBC
癬	xuanBM
贙	xuanBN
轩	xuanC
軒	xuanCM
衒	xuanCN
蜁	xuanCO
蝖	xuanCP
轋	xuanCQ
蠉	xuanCR
券	xuanD
漩	xuanE
渲	xuanEB
泫	xuanEC
旋	xuanF
绚	xuanFB
絢	xuanFM
縣	xuanFN
縇	xuanFO
颴	xuanFP
縼	xuanFQ
繏	xuanFR
弲	xuanGM
鞙	xuanGN
炫	xuanH
煊	xuanHB
烜	xuanHM
煖	xuanHN
楦	xuanI
梋	xuanIM
楥	xuanIN
檈	xuanIO
铉	xuanJ
镟	xuanJB
鉉	xuanJM
鏇	xuanJN
鋗	xuanJO
鍹	xuanJP
鐶	xuanJQ
袨	xuanKM
箮	xuanKN
眩	xuanM
眴	xuanMM
睻	xuanMN
駨	xuanMO
駽	xuanMP
矎	xuanMQ
妶	xuanNM
媗	xuanNN
嫙	xuanNO
嬛	xuanNP
喧	xuanO
吅	xuanOM
咺	xuanON
喛	xuanOO
碹	xuanP
狟	xuanQM
獧	xuanQN
暄	xuanR
昍	xuanRM
昡	xuanRN
晅	xuanRO
暅	xuanRP
暶	xuanRQ
县	xuanS
禤	xuanSM
塇	xuanTM
萱	xuanU
萲	xuanUM
蓒	xuanUN
蔙	xuanUO
蕿	xuanUP
蘐	xuanUQ
藼	xuanUR
儇	xuanV
伭	xuanVM
璇	xuanW
玹	xuanWM
琄	xuanWN
琁	xuanWO
瑄	xuanWP
敻	xuanWQ
璿	xuanWR
玄	xuanX
悬	xuanXB
懸	xuanXM
怰	xuanXN
愋	xuanXO
愃	xuanXP
懁	xuanXQ
谖	xuanY
諼	xuanYM
翧	xuanYN
諠	xuanYO
翾	xuanYP
鰚	xuanYQ
譞	xuanYR
讂	xuanYS
选	xuanZ
選	xuanZM
夐	xuanZN
疞	xuBM
賉	xuBN
鬚	xuBO
徐	xuC
蚼	xuCM
蛡	xuCN
蝑	xuCO
殈	xuDM
浒	xuE
溆	xuEB
疦	xueBM
疶	xueBN
洫	xuEC
轌	xueCM
削	xueD
泶	xueE
澩	xueEM
泧	xueEN
泬	xueEO
滈	xueEP
瀥	xueEQ
靴	xueG
鞾	xueGM
燢	xueHM
桖	xueIM
梋	xueIN
樰	xueIO
觷	xueJM
袕	xueKM
膤	xueLM
漵	xuEM
瞲	xueMM
滸	xuEN
鸴	xueNM
鷽	xueNN
噱	xueO
汿	xuEOL
吷	xueOM
沀	xuEP
淢	xuEQ
狘	xueQM
雪	xueR
湏	xuERL
湑	xuES
岤	xueSM
峃	xueSN
嶨	xueSO
滀	xuET
坹	xueTM
壆	xueTN
薛	xueU
潊	xuEUL
茓	xueUM
蒆	xueUN
乴	xueVM
斈	xueWM
敩	xueWN
斆	xueWO
血	xueX
穴	xueXB
彐	xueXC
怴	xueXM
辥	xueXN
辪	xueXO
谑	xueY
鳕	xueYB
謔	xueYM
鱈	xueYN
学	xueZ
踅	xueZB
學	xueZM
趐	xueZN
艝	xueZO
续	xuF
绪	xuFB
絮	xuFC
緒	xuFM
續	xuFN
聓	xuFO
続	xuFP
綇	xuFQ
鄦	xuFR
聟	xuFS
緖	xuFT
緰	xuFU
縃	xuFV
繻	xuFW
序	xuG
戌	xuGB
魆	xuGM
魖	xuGN
虚	xuH
煦	xuHB
虛	xuHM
烅	xuHN
虗	xuHO
烼	xuHP
稰	xuHQ
稸	xuHR
燸	xuHS
栩	xuI
楈	xuIM
槒	xuIN
卹	xuJM
幁	xuJN
銊	xuJO
鑐	xuJP
裇	xuKM
胥	xuL
勖	xuLB
肷	xuLC
胊	xuLM
勗	xuLN
盱	xuM
糈	xuMB
眗	xuMM
矞	xuMN
瞁	xuMO
盢	xuMP
盨	xuMQ
驉	xuMR
婿	xuN
揗	xunAM
撏	xunAN
巽	xunB
寻	xunC
循	xunCB
徇	xunCC
尋	xunCM
蟫	xunCN
蟳	xunCO
殉	xunD
奞	xunDM
洵	xunE
浚	xunEB
汛	xunEC
浔	xunED
潯	xunEM
潠	xunEN
濬	xunEO
灥	xunEP
郇	xunF
紃	xunFM
鄩	xunFN
纁	xunFO
熏	xunH
焄	xunHM
稄	xunHN
煇	xunHO
燅	xunHP
燂	xunHQ
燖	xunHR
燻	xunHS
爓	xunHT
爋	xunHU
杊	xunIM
栒	xunIN
桪	xunIO
樳	xunIP
鑂	xunJM
襑	xunKM
勋	xunL
勛	xunLM
勲	xunLN
勳	xunLO
臐	xunLP
驯	xunM
姁	xuNML
馴	xunMM
毥	xunMN
眴	xunMO
駨	xunMP
矄	xunMQ
妶	xuNN
姰	xunNM
鶽	xunNN
媭	xuNO
咰	xunOM
噚	xunON
噀	xunOO
嚑	xunOP
嬃	xuNP
殾	xunPM
醺	xunQ
獯	xunQB
狥	xunQM
旬	xunR
曛	xunRB
峋	xunS
卂	xunSM
巺	xunSN
埙	xunT
塤	xunTM
坃	xunTN
畃	xunTO
壎	xunTP
壦	xunTQ
荀	xunU
薰	xunUB
蕈	xunUC
荨	xunUD
葷	xunUM
蕁	xunUN
蔒	xunUO
薫	xunUP
蘍	xunUQ
伨	xunVM
侚	xunVN
偱	xunVO
珣	xunWM
璕	xunWN
窨	xunX
恂	xunXB
愻	xunXM
训	xunY
讯	xunYB
询	xunYC
鲟	xunYD
訓	xunYM
訊	xunYN
詢	xunYO
鱘	xunYP
廵	xunYQ
訙	xunYR
顨	xunYS
鱏	xunYT
迅	xunZ
巡	xunZB
逊	xunZC
孫	xunZM
遜	xunZN
迿	xunZO
攳	xunZP
吁	xuO
嘘	xuOB
噓	xuOM
呴	xuON
喐	xuOO
喣	xuOP
嘼	xuOQ
砉	xuP
酗	xuQ
醑	xuQB
欨	xuQM
欰	xuQN
欻	xuQO
歔	xuQP
獝	xuQQ
歘	xuQR
需	xuR
旭	xuRB
旴	xuRM
昫	xuRN
晇	xuRO
朂	xuRP
暊	xuRQ
壻	xuSM
禑	xuSN
畜	xuT
墟	xuTB
圩	xuTC
垿	xuTM
冔	xuTN
蓄	xuU
蓿	xuUB
芧	xuUM
蒣	xuUN
蓲	xuUO
蕦	xuUP
藇	xuUQ
藚	xuUR
伵	xuVM
侐	xuVN
俆	xuVO
偦	xuVP
敘	xuWM
珬	xuWN
珝	xuWO
敍	xuWP
恤	xuX
怴	xuXM
恓	xuXN
惐	xuXO
慉	xuXP
窢	xuXQ
许	xuY
须	xuYB
叙	xuYC
诩	xuYD
顼	xuYE
許	xuYM
須	xuYN
頊	xuYO
詡	xuYP
謳	xuYQ
訏	xuYR
谞	xuYS
訹	xuYT
魣	xuYU
諿	xuYV
諝	xuYW
譃	xuYX
鱮	xuYY
押	yaA
揠	yaAB
拁	yaAM
挜	yaAN
掗	yaAO
痖	yaB
瘂	yaBM
冴	yaBN
疨	yaBO
压	yaC
衙	yaCB
轧	yaCC
蚜	yaCD
軋	yaCM
厭	yaCN
輅	yaCO
厊	yaCP
厑	yaCQ
厓	yaCR
輵	yaCS
齖	yaCT
齾	yaCU
涯	yaE
漄	yaEM
潝	yaEN
聐	yaFM
庌	yaGM
庘	yaGN
亚	yaH
亞	yaHM
亜	yaHN
稏	yaHO
桠	yaI
椏	yaIM
枒	yaIN
椻	yaIO
铔	yaJM
釾	yaJN
錏	yaJO
鐚	yaJP
笌	yaKM
丫	yaL
劜	yaLM
睚	yaM
鸭	yaN
掩	yanA
抁	yanAM
挻	yanAN
挩	yanAO
掞	yanAP
揜	yanAQ
揅	yanAR
宴	yanB
赝	yanBB
鸦	yaNBL
贗	yanBM
贋	yanBN
厌	yanC
衍	yanCB
蜒	yanCC
厣	yanCD
娅	yaNCL
厭	yanCM
厴	yanCN
蝘	yanCO
厳	yanCP
齞	yanCQ
齴	yanCR
奄	yanD
剡	yanDB
夵	yanDM
剦	yanDN
殗	yanDO
演	yanE
沿	yanEB
淹	yanEC
湮	yanED
滟	yanEE
灩	yanEM
沇	yanEN
洝	yanEO
淊	yanEP
湺	yanEQ
渰	yanER
渷	yanES
溎	yanET
漹	yanEU
灔	yanEV
灎	yanEW
灧	yanEX
鄢	yanF
郾	yanFB
阽	yanFC
郔	yanFM
匽	yanFN
隁	yanFO
隒	yanFP
綖	yanFQ
縯	yanFR
酀	yanFS
豓	yanFT
豔	yanFU
魇	yanG
扬	yangA
揚	yangAM
抰	yangAN
攁	yangAO
养	yangB
痒	yangBB
疡	yangBC
瘍	yangBM
癢	yangBN
徉	yangC
蛘	yangCB
軮	yangCM
蝆	yangCN
輰	yangCO
央	yangD
殃	yangDB
洋	yangE
漾	yangEB
泱	yangEC
潒	yangEM
瀁	yangEN
阳	yangF
陽	yangFM
阦	yangFN
飏	yangFO
紻	yangFP
颺	yangFQ
鞅	yangG
炀	yangH
秧	yangHB
烊	yangHC
煬	yangHM
炴	yangHN
样	yangI
杨	yangIB
楊	yangIM
樣	yangIN
柍	yangIO
楧	yangIP
様	yangIQ
卬	yangJM
钖	yangJN
锳	yangJO
鉠	yangJP
鍈	yangJQ
鍚	yangJR
鐊	yangJS
劷	yangLM
胦	yangLN
勜	yangLO
魘	yanGM
眏	yangMM
眻	yangMN
駚	yangMO
鸯	yangN
弇	yanGNL
鴦	yangNM
姎	yangNN
婸	yangNO
鴹	yangNP
鸉	yangNQ
戭	yanGO
咉	yangOM
鬳	yanGP
礢	yangPM
氧	yangQ
氜	yangQM
氱	yangQN
歍	yangQO
旸	yangRM
昜	yangRN
雵	yangRO
暘	yangRP
霷	yangRQ
養	yangSM
岟	yangSN
崸	yangSO
崵	yangSP
飬	yangSQ
禓	yangSR
坱	yangTM
垟	yangTN
仰	yangV
佯	yangVB
佒	yangVM
傟	yangVN
玚	yangWM
珜	yangWN
瑒	yangWO
敭	yangWP
恙	yangX
怏	yangXB
愓	yangXM
慃	yangXN
懩	yangXO
羊	yangY
詳	yangYM
羏	yangYN
羕	yangYO
詇	yangYP
諹	yangYQ
鰑	yangYR
严	yanH
烟	yanHB
焰	yanHC
炎	yanHD
燕	yanHE
焉	yanHF
焱	yanHG
煙	yanHM
炏	yanHN
烻	yanHO
焔	yanHP
扊	yanHQ
熖	yanHR
虤	yanHS
燄	yanHT
黰	yanHTL
黡	yanHU
黶	yanHUL
黤	yanHV
爓	yanHW
黫	yanHX
黬	yanHY
黭	yanHZ
檐	yanI
梴	yanIM
棪	yanIN
椻	yanIO
椼	yanIP
楌	yanIQ
樮	yanIR
橪	yanIS
檿	yanIT
櫩	yanIU
欕	yanIV
铅	yanJ
鉛	yanJM
錟	yanJN
觃	yanJO
覎	yanJP
觾	yanJQ
筵	yanK
裺	yanKM
褗	yanKN
篶	yanKO
簷	yanKP
胭	yanL
腌	yanLB
鹽	yanLM
臙	yanLN
麙	yanLO
龑	yanLP
麣	yanLQ
眼	yanM
验	yanMB
阎	yanMC
盐	yanMD
阉	yanME
闫	yanMF
阏	yanMG
鴉	yaNML
閹	yanMM
閻	yanMN
驗	yanMO
閆	yanMP
閼	yanMQ
験	yanMR
騐	yanMS
騴	yanMT
驠	yanMU
嫣	yanN
妍	yanNB
鴨	yaNNL
妟	yanNM
牪	yanNN
姸	yanNO
娫	yanNP
姲	yanNQ
娮	yanNR
媕	yanNS
鳫	yanNT
鳱	yanNU
嬊	yanNV
嬿	yanNVL
鴈	yanNW
鶠	yanNWL
嬐	yanNX
鷃	yanNXL
嬮	yanNY
孍	yanNYL
鴳	yanNZ
鷰	yanNZL
咽	yanO
唁	yanOB
婭	yaNOL
嚴	yanOM
唌	yanON
啱	yanOO
喦	yanOP
喭	yanOQ
噞	yanOR
嚈	yanOS
嚥	yanOT
囐	yanOU
研	yanP
殷	yanPB
砚	yanPC
姶	yaNPL
硯	yanPM
硏	yanPN
硽	yanPO
碞	yanPP
礹	yanPQ
酽	yanQ
鵶	yaNQL
釅	yanQM
狿	yanQN
酓	yanQO
猏	yanQP
猒	yanQQ
歅	yanQR
醃	yanQS
醶	yanQT
醼	yanQU
晏	yanR
昖	yanRM
晻	yanRN
暥	yanRO
曕	yanRP
曣	yanRQ
曮	yanRR
艳	yanS
岩	yanSB
彦	yanSC
鼹	yanSD
罨	yanSE
餍	yanSF
崦	yanSG
彥	yanSM
巖	yanSN
艷	yanSO
鼴	yanSP
饜	yanSQ
豜	yanSR
嵒	yanSS
嵓	yanST
嵃	yanSU
嵼	yanSV
巌	yanSVL
嶖	yanSW
軅	yanSWL
嶮	yanSX
巗	yanSXL
躽	yanSY
巘	yanSYL
艶	yanSZ
巚	yanSZL
兖	yanT
堰	yanTB
埏	yanTC
兗	yanTM
円	yanTN
塩	yanTO
墕	yanTP
壛	yanTQ
壧	yanTR
芫	yanU
菸	yanUB
薟	yanUM
莚	yanUN
菴	yanUO
萒	yanUP
蔅	yanUQ
俨	yanV
偃	yanVB
儼	yanVM
乵	yanVN
偣	yanVO
偐	yanVP
傿	yanVQ
琰	yanW
珚	yanWM
琂	yanWN
敥	yanWO
甗	yanWP
恹	yanX
懨	yanXM
愝	yanXN
窴	yanXO
懕	yanXP
言	yanY
颜	yanYB
延	yanYC
谚	yanYD
谳	yanYE
讠	yanYF
諺	yanYM
顏	yanYN
訁	yanYO
讞	yanYP
訮	yanYQ
詽	yanYR
羬	yanYS
顔	yanYT
鰋	yanYU
顩	yanYV
讌	yanYW
雁	yanZ
趼	yanZB
遃	yanZM
呀	yaO
摇	yaoA
搖	yaoAM
抭	yaoAN
揺	yaoAO
摿	yaoAP
撽	yaoAQ
哑	yaOB
疟	yaoBL
瘧	yaoBM
宎	yaoBN
匋	yaoBO
皐	yaoBP
鼼	yaoBQ
徭	yaoC
轺	yaoCB
吖	yaOCL
軺	yaoCM
徺	yaoCN
齩	yaoCO
夭	yaoD
殀	yaoDM
滧	yaoEM
溔	yaoEN
约	yaoF
陶	yaoFB
繇	yaoFC
約	yaoFM
隃	yaoFN
飖	yaoFO
颻	yaoFP
纅	yaoFQ
靿	yaoGM
烑	yaoHM
烄	yaoHN
熎	yaoHO
燿	yaoHP
杳	yaoI
枖	yaoIM
柼	yaoIN
楆	yaoIO
榣	yaoIP
榚	yaoIQ
钥	yaoJ
舀	yaoJB
铫	yaoJC
鑰	yaoJM
銚	yaoJN
覞	yaoJO
鎐	yaoJP
袎	yaoKM
筄	yaoKN
箹	yaoKO
腰	yaoL
肴	yaoLB
麽	yaoM
啞	yaOML
驁	yaoMM
眑	yaoMN
闄	yaoMO
騕	yaoMP
矅	yaoMQ
妖	yaoN
姚	yaoNB
鹞	yaoNC
呾	yaONL
鷂	yaoNM
婹	yaoNN
媱	yaoNO
鴁	yaoNP
鴢	yaoNQ
鷕	yaoNR
咬	yaoO
吆	yaoOB
唖	yaOOL
喓	yaoOM
嗂	yaoON
噛	yaoOO
么	yaoP
殽	yaoPM
磘	yaoPN
狕	yaoQM
猺	yaoQN
獟	yaoQO
曜	yaoR
暚	yaoRM
曣	yaoRN
崾	yaoS
岆	yaoSM
祅	yaoSN
峣	yaoSO
餆	yaoSP
嶢	yaoSQ
嶤	yaoSR
餚	yaoSS
堯	yaoTM
垚	yaoTN
药	yaoU
藥	yaoUM
蕘	yaoUN
苭	yaoUO
葽	yaoUP
葯	yaoUQ
蓔	yaoUR
薬	yaoUS
蘨	yaoUT
侥	yaoV
僥	yaoVM
仸	yaoVN
倄	yaoVO
偠	yaoVP
傜	yaoVQ
瑶	yaoW
尧	yaoWB
珧	yaoWC
瑤	yaoWM
尭	yaoWN
要	yaoX
窑	yaoXB
窈	yaoXC
爻	yaoXD
窯	yaoXM
怮	yaoXN
玅	yaoXO
恌	yaoXP
穾	yaoXQ
窅	yaoXR
窔	yaoXS
愮	yaoXT
窰	yaoXU
耀	yaoY
谣	yaoYB
幺	yaoYC
鳐	yaoYD
謠	yaoYM
鰩	yaoYN
訞	yaoYO
詏	yaoYP
謡	yaoYQ
顤	yaoYR
鱙	yaoYS
讑	yaoYT
遥	yaoZ
邀	yaoZB
遙	yaoZM
艞	yaoZN
邎	yaoZO
砑	yaP
磍	yaPM
氩	yaQ
氬	yaQM
犽	yaQN
猚	yaQO
猰	yaQP
崖	yaS
岈	yaSB
崕	yaSM
垭	yaT
壓	yaTM
埡	yaTN
圠	yaTO
圧	yaTP
堐	yaTQ
芽	yaU
蕥	yaUM
伢	yaV
俹	yaVM
琊	yaW
玡	yaWM
圔	yaWN
瓛	yaWO
襾	yaXM
覀	yaXN
穵	yaXO
窫	yaXP
牙	yaY
讶	yaYB
訝	yaYM
雅	yaZ
迓	yaZB
疋	yaZC
孲	yaZM
拽	yeA
揶	yeAB
掖	yeAC
揲	yeAD
抴	yeAM
捓	yeAN
捙	yeAO
擛	yeAP
擖	yeAQ
擫	yeAR
擨	yeAS
擪	yeAT
冶	yeB
痷	yeBM
皣	yeBN
靥	yeC
蠮	yeCM
殗	yeDM
殕	yeDN
液	yeE
洂	yeEM
漜	yeEN
潱	yeEO
澲	yeEP
爷	yeF
耶	yeFB
邪	yeFC
邺	yeFD
爺	yeFM
鄴	yeFN
緤	yeFO
烨	yeH
燁	yeHM
焆	yeHN
煠	yeHO
熀	yeHP
爗	yeHQ
椰	yeI
業	yeIM
枒	yeIN
枼	yeIO
枽	yeIP
楪	yeIQ
铘	yeJ
鋣	yeJM
釾	yeJN
鎁	yeJO
鍱	yeJP
鎑	yeJQ
鐷	yeJR
野	yeL
曳	yeLB
腋	yeLC
靨	yeMM
瞱	yeMN
瞸	yeMO
驜	yeMP
鵺	yeNM
鸈	yeNN
叶	yeO
咽	yeOB
噎	yeOC
吔	yeOM
嘢	yeON
嚥	yeOO
礏	yePM
歋	yeQM
晔	yeR
曄	yeRM
曵	yeRN
暍	yeRO
曅	yeRP
曗	yeRQ
峫	yeSM
馌	yeSN
嶪	yeSO
嶫	yeSP
餣	yeSQ
饁	yeSR
亪	yeTM
亱	yeTN
埜	yeTO
堨	yeTP
墷	yeTQ
壄	yeTR
葉	yeUM
也	yeV
倻	yeVM
僷	yeVN
瑘	yeWM
璍	yeWN
瓛	yeWO
夜	yeX
窫	yeXM
业	yeY
页	yeYB
谒	yeYC
頁	yeYM
謁	yeYN
抑	yiA
揖	yiAB
挹	yiAC
扡	yiAM
拸	yiAN
掜	yiAO
搤	yiAP
撎	yiAQ
疑	yiB
宜	yiBB
疫	yiBC
贻	yiBD
痍	yiBE
肄	yiBF
癔	yiBG
瘗	yiBH
貽	yiBM
瘞	yiBN
匇	yiBO
宐	yiBP
貤	yiBQ
宧	yiBR
痬	yiBS
兿	yiBT
瘱	yiBU
賹	yiBV
寲	yiBW
寱	yiBX
贀	yiBY
役	yiC
蚁	yiCB
蜴	yiCC
轶	yiCD
蛇	yiCE
蟻	yiCM
軼	yiCN
彵	yiCO
虵	yiCP
蛦	yiCQ
蛜	yiCR
蛡	yiCS
輢	yiCT
輗	yiCU
螘	yiCV
螔	yiCW
螠	yiCX
轙	yiCY
齮	yiCZ
齸	yiCZL
义	yiD
夷	yiDB
奕	yiDC
刈	yiDD
劓	yiDE
殪	yiDF
殔	yiDM
已	yiE
溢	yiEB
漪	yiEC
沂	yiED
沶	yiEM
泆	yiEN
洟	yiEO
洩	yiEP
洢	yiEQ
浂	yiER
浳	yiES
浥	yiET
渏	yiEU
湙	yiEV
潩	yiEW
澺	yiEX
瀷	yiEY
医	yiF
绎	yiFB
旖	yiFC
缢	yiFD
繹	yiFM
紲	yiFN
縊	yiFO
匜	yiFP
阣	yiFQ
耴	yiFR
陭	yiFS
郼	yiFT
鄓	yiFU
旑	yiFV
絏	yiFW
繄	yiFX
繶	yiFY
异	yiG
羿	yiGB
弈	yiGC
庡	yiGM
弬	yiGN
骮	yiGO
靾	yiGP
廙	yiGQ
一	yiH
移	yiHB
熠	yiHC
黟	yiHD
戺	yiHM
秇	yiHN
炈	yiHO
扅	yiHP
扆	yiHQ
焬	yiHR
焲	yiHS
煕	yiHT
稦	yiHU
熈	yiHV
穓	yiHVL
黓	yiHW
燚	yiHWL
熼	yiHX
燡	yiHXL
熪	yiHY
燱	yiHYL
熤	yiHZ
黳	yiHZL
椅	yiI
杙	yiIM
杝	yiIN
枍	yiIO
枻	yiIP
柂	yiIQ
桋	yiIR
栧	yiIS
栺	yiIT
栘	yiIU
棭	yiIV
椬	yiIW
槸	yiIWL
椸	yiIX
檍	yiIXL
榏	yiIY
檥	yiIYL
槷	yiIZ
檹	yiIZL
镒	yiJ
铱	yiJB
镱	yiJC
钇	yiJD
銥	yiJM
釔	yiJN
鎰	yiJO
鐿	yiJP
帠	yiJQ
帟	yiJR
釴	yiJS
釶	yiJT
幆	yiJU
鈘	yiJV
鈠	yiJW
鉯	yiJX
鏔	yiJXL
銕	yiJY
觺	yiJYL
錡	yiJZ
钀	yiJZL
衣	yiK
裔	yiKB
衤	yiKC
衪	yiKM
衵	yiKN
笖	yiKO
袣	yiKP
袘	yiKQ
裛	yiKR
裿	yiKS
褘	yiKT
篒	yiKU
箷	yiKV
褹	yiKW
簃	yiKX
籎	yiKY
襼	yiKZ
翌	yiL
翊	yiLB
臆	yiLC
胰	yiLD
肊	yiLM
劮	yiLN
耛	yiLO
勚	yiLP
竩	yiLQ
勩	yiLR
膉	yiLS
益	yiM
驿	yiMB
眙	yiMC
睪	yiMM
驛	yiMN
冝	yiMO
駅	yiMP
瞖	yiMQ
姨	yiN
瘾	yinB
寅	yinBB
癮	yinBM
凐	yinBN
瘖	yinBO
癊	yinBP
蚓	yinC
龈	yinCB
齦	yinCM
龂	yinCN
輑	yinCO
螾	yinCP
蟫	yinCQ
齗	yinCR
殥	yinDM
淫	yinE
湮	yinEB
洇	yinEC
洕	yinEM
泿	yinEN
淾	yinEO
湚	yinEP
溵	yinEQ
滛	yinER
濦	yinES
濥	yinET
隐	yinF
阴	yinFB
鄞	yinFC
陰	yinFM
隱	yinFN
阥	yinFO
陻	yinFP
隂	yinFQ
絪	yinFR
隠	yinFS
緸	yinFT
縯	yinFU
引	yinG
撄	yingA
攖	yingAM
摬	yingAN
攍	yingAO
赢	yingB
瘿	yingBB
贏	yingBM
癭	yingBN
賏	yingBO
蝇	yingC
螢	yingCM
蠅	yingCN
蛍	yingCO
蝧	yingCP
蝿	yingCQ
蠳	yingCR
滢	yingE
瀛	yingEB
潆	yingEC
滎	yingEM
潁	yingEN
瀅	yingEO
瀠	yingEP
浧	yingEQ
渶	yingER
溁	yingES
溋	yingET
濚	yingEU
濴	yingEV
濙	yingEW
瀯	yingEX
瀴	yingEY
灐	yingEZ
灜	yingEZL
缨	yingF
郢	yingFB
罂	yingFC
纓	yingFM
縈	yingFN
罌	yingFO
耺	yingFP
绬	yingFQ
緓	yingFR
縄	yingFS
罃	yingFT
应	yingG
鞕	yingGM
廮	yingGN
荧	yingH
熒	yingHM
穎	yingHN
營	yingHO
焸	yingHP
焽	yingHQ
煐	yingHR
爃	yingHS
樱	yingI
楹	yingIB
櫻	yingIM
柍	yingIN
桜	yingIO
桯	yingIP
梬	yingIQ
楧	yingIR
櫿	yingIS
鎣	yingJM
锳	yingJN
覮	yingJO
鐛	yingJP
鑍	yingJQ
褮	yingKM
籝	yingKN
籯	yingKO
膺	yingL
媵	yingLB
朠	yingLM
膡	yingLN
盈	yingM
靷	yinGML
盁	yingMM
眏	yingMN
鹰	yingN
婴	yingNB
嬴	yingNC
鹦	yingND
廕	yinGNL
嬰	yingNM
鷹	yingNN
鶯	yingNO
鸚	yingNP
媖	yingNQ
嫈	yingNR
鴬	yingNS
鶧	yingNT
鶑	yingNU
孆	yingNV
鷪	yingNW
鸎	yingNX
嘤	yingO
鞇	yinGOL
嚶	yingOM
啨	yingON
営	yingOO
噟	yingOP
硬	yingP
碤	yingPM
礯	yingPN
映	yingR
旲	yingRM
暎	yingRN
霙	yingRO
影	yingS
矨	yingSM
嵤	yingSN
禜	yingSO
巆	yingSP
巊	yingSQ
軈	yingSR
塋	yingTM
英	yingU
营	yingUB
莹	yingUC
莺	yingUD
萤	yingUE
萦	yingUF
荥	yingUG
茔	yingUH
蓥	yingUI
萾	yingUM
藀	yingUN
蘡	yingUO
俓	yingVM
偀	yingVN
僌	yingVO
瑛	yingW
璎	yingWB
瑩	yingWM
瓔	yingWN
珱	yingWO
甇	yingWP
甖	yingWQ
應	yingXM
応	yingXN
愥	yingXO
颖	yingY
颍	yingYB
颕	yingYM
頴	yingYN
韺	yingYO
謍	yingYP
韹	yingYQ
譍	yingYR
譻	yingYS
鱦	yingYT
迎	yingZ
夃	yingZM
孾	yingZN
烎	yinHM
秵	yinHN
栶	yinIM
梀	yinIN
檃	yinIO
檭	yinIP
檼	yinIQ
櫽	yinIR
银	yinJ
印	yinJB
铟	yinJC
銀	yinJM
銦	yinJN
斦	yinJO
鈝	yinJP
釿	yinJQ
鈏	yinJR
裀	yinKM
筃	yinKN
乁	yiNM
冘	yinMM
骃	yinMN
粌	yinMO
駰	yinMP
闉	yinMQ
闇	yinMR
姻	yinN
妷	yiNNL
鶂	yiNNLL
婬	yinNM
婣	yinNN
鷣	yinNO
吟	yinO
喑	yinOB
吲	yinOC
鳦	yiNOL
鶃	yiNOLL
唫	yinOM
噖	yinON
噾	yinOO
嚚	yinOP
殷	yinP
胤	yinPB
媐	yiNPL
鷊	yiNPLL
乑	yinPM
硍	yinPN
碒	yinPO
磤	yinPP
氤	yinQ
狺	yinQB
嫛	yiNQL
鷁	yiNQLL
犾	yinQM
欭	yinQN
酓	yinQO
猌	yinQP
歅	yinQQ
酳	yinQR
霪	yinR
嫕	yiNRL
鷖	yiNRLL
朄	yinRM
霒	yinRN
霠	yinRO
饮	yinS
鹝	yiNSL
鷧	yiNSLL
飲	yinSM
岃	yinSN
峾	yinSO
崟	yinSP
崯	yinSQ
飮	yinSR
禋	yinSS
嶾	yinST
垠	yinT
堙	yinTB
鹢	yiNTL
鸃	yiNTLL
垔	yinTM
垽	yinTN
堷	yinTO
茵	yinU
荫	yinUB
茚	yinUC
嬄	yiNUL
鷾	yiNULL
蔭	yinUM
苂	yinUN
荶	yinUO
蒑	yinUP
蔩	yinUQ
蘟	yinUR
尹	yinV
鹥	yiNVL
伒	yinVM
侌	yinVN
傿	yinVO
因	yinW
嬑	yiNWL
囙	yinWM
珢	yinWN
圁	yinWO
璌	yinWP
窨	yinX
夤	yinXB
嬟	yiNXL
愔	yinXM
慇	yinXN
慭	yinXO
憖	yinXP
憗	yinXQ
懚	yinXR
音	yinY
廴	yinYB
鴺	yiNYL
訔	yinYM
訚	yinYN
訢	yinYO
訡	yinYP
誾	yinYQ
鮣	yinYR
諲	yinYS
韾	yinYT
讔	yinYU
夂	yinZ
鶍	yiNZL
赺	yinZM
趛	yinZN
咦	yiO
邑	yiOB
呓	yiOC
咿	yiOD
噫	yiOE
嗌	yiOF
囈	yiOM
吚	yiON
呭	yiOO
呹	yiOP
唈	yiOQ
毅	yiP
尾	yiPB
殹	yiPM
毉	yiPN
礒	yiPO
欹	yiQ
猗	yiQB
酏	yiQC
醫	yiQM
欥	yiQN
狋	yiQO
狏	yiQP
欭	yiQQ
獈	yiQR
歖	yiQS
歝	yiQT
醳	yiQU
醷	yiQV
易	yiR
曵	yiRM
昳	yiRN
晹	yiRO
暆	yiRP
曀	yiRQ
曎	yiRR
霬	yiRS
靉	yiRT
矣	yiS
屹	yiSB
壹	yiSC
嶷	yiSD
饴	yiSE
峄	yiSF
飴	yiSM
嶧	yiSN
壱	yiSO
祎	yiSP
峓	yiSQ
巸	yiSR
豛	yiSS
豙	yiST
崺	yiSU
饐	yiSUL
禕	yiSV
叆	yiSW
夁	yiSX
嶬	yiSY
豷	yiSZ
亦	yiT
圯	yiTB
埸	yiTC
異	yiTM
坄	yiTN
垼	yiTO
埶	yiTP
畩	yiTQ
墿	yiTR
艺	yiU
艾	yiUB
荑	yiUC
苡	yiUD
薏	yiUE
藝	yiUM
芅	yiUN
苅	yiUO
苢	yiUP
萟	yiUQ
萓	yiUR
蓺	yiUS
藙	yiUT
蘙	yiUU
虉	yiUV
以	yiV
依	yiVB
伊	yiVC
仪	yiVD
亿	yiVE
乙	yiVF
倚	yiVG
佚	yiVH
佾	yiVI
仡	yiVJ
億	yiVM
儀	yiVN
乚	yiVO
伇	yiVP
伿	yiVQ
佁	yiVR
侇	yiVS
俋	yiVT
偯	yiVU
亄	yiVV
儗	yiVW
攺	yiWM
玴	yiWN
珆	yiWO
瓵	yiWP
敧	yiWQ
敡	yiWR
敼	yiWS
瑿	yiWT
圛	yiWU
斁	yiWV
意	yiX
忆	yiXB
怡	yiXC
懿	yiXD
彝	yiXE
悒	yiXF
怿	yiXG
憶	yiXM
彜	yiXN
懌	yiXO
乂	yiXP
忔	yiXQ
怈	yiXR
恞	yiXS
悘	yiXT
悥	yiXU
彛	yiXV
懝	yiXW
彞	yiXX
议	yiY
翼	yiYB
译	yiYC
谊	yiYD
诣	yiYE
颐	yiYF
弋	yiYG
翳	yiYH
诒	yiYI
羛	yiYJ
詍	yiYK
詑	yiYL
詣	yiYM
羠	yiYML
義	yiYN
頉	yiYNL
誼	yiYO
誃	yiYOL
頤	yiYP
頥	yiYPL
譯	yiYQ
顊	yiYQL
議	yiYR
鮧	yiYRL
詒	yiYS
鮨	yiYSL
誒	yiYT
謻	yiYTL
謚	yiYU
顗	yiYUL
弌	yiYV
鯣	yiYVL
叕	yiYW
譩	yiYWL
訑	yiYX
譺	yiYXL
訲	yiYY
讉	yiYYL
訳	yiYZ
讛	yiYZL
遗	yiZ
逸	yiZB
迤	yiZC
舣	yiZD
遺	yiZM
艤	yiZN
辷	yiZO
迆	yiZP
迱	yiZQ
迻	yiZR
逘	yiZS
隿	yiZT
攲	yiZU
跇	yiZV
跠	yiZW
踦	yiZX
艗	yiZY
貖	yiZZ
拥	yongA
擁	yongAM
揘	yongAN
痈	yongB
癰	yongBM
癕	yongBN
蛹	yongC
邕	yongCB
永	yongE
涌	yongEB
泳	yongEC
湧	yongEM
滽	yongEN
澭	yongEO
灉	yongEP
鄘	yongFM
郺	yongFN
庸	yongG
廱	yongGM
栐	yongIM
柡	yongIN
槦	yongIO
镛	yongJ
鏞	yongJM
銿	yongJN
筩	yongKM
勇	yongL
臃	yongLB
勈	yongLM
嫞	yongNM
鷛	yongNN
咏	yongO
喁	yongOB
嗈	yongOM
噰	yongON
砽	yongPM
硧	yongPN
牗	yongPO
牅	yongPP
醟	yongQM
饔	yongS
嵱	yongSM
彮	yongSN
禜	yongSO
雍	yongT
墉	yongTB
壅	yongTC
埇	yongTM
塎	yongTN
苚	yongUM
蒏	yongUN
佣	yongV
俑	yongVB
傭	yongVM
傛	yongVN
慵	yongX
恿	yongXB
怺	yongXM
悀	yongXN
惥	yongXO
愑	yongXP
愹	yongXQ
慂	yongXR
用	yongY
甬	yongYB
鳙	yongYC
詠	yongYM
鱅	yongYN
颙	yongYO
鲬	yongYP
顒	yongYQ
鯒	yongYR
鰫	yongYS
踊	yongZ
踴	yongZM
雝	yongZN
哟	yoO
唷	yoOB
喲	yoOM
揂	youAM
宥	youB
疣	youBB
卣	youBC
痏	youBM
釉	youC
蝣	youCB
蚰	youCC
蚴	youCD
蝤	youCE
蚘	youCM
蜏	youCN
輏	youCO
輶	youCP
游	youE
油	youEB
沋	youEM
汼	youEN
泑	youEO
浟	youEP
湵	youEQ
滺	youER
瀀	youES
邮	youF
繇	youFB
郵	youFM
斿	youFN
聈	youFO
鄾	youFP
纋	youFQ
庮	youGM
戭	youGN
黝	youH
丣	youHM
秞	youHN
柚	youI
栯	youIM
梄	youIN
梎	youIO
楢	youIP
槱	youIQ
櫌	youIR
櫾	youIS
铀	youJ
铕	youJB
鈾	youJM
銹	youJN
銪	youJO
褏	youKM
褎	youKN
有	youL
肬	youLM
麀	youLN
耰	youLO
冘	youMM
駀	youMN
妋	youNM
牰	youNN
姷	youNO
右	youO
呦	youOB
哊	youOM
唀	youON
嚘	youOO
牖	youP
牗	youPM
犹	youQ
猷	youQB
酉	youQC
猶	youQM
狖	youQN
酭	youQO
獶	youQP
獿	youQQ
幽	youS
鼬	youSB
峟	youSM
祐	youSN
峳	youSO
禉	youSP
由	youT
甴	youTM
亴	youTN
莜	youU
莠	youUB
莸	youUC
蕕	youUM
苃	youUN
莤	youUO
蒏	youUP
优	youV
佑	youVB
攸	youVC
侑	youVD
優	youVM
偤	youVN
囿	youW
悠	youX
忧	youXB
憂	youXM
怞	youXN
怮	youXO
怣	youXP
懮	youXQ
又	youY
友	youYB
尤	youYC
诱	youYD
幼	youYE
鱿	youYF
尢	youYG
誘	youYM
魷	youYN
羑	youYO
訧	youYP
鲉	youYQ
羪	youYR
鮋	youYS
遊	youZM
孧	youZN
迶	youZO
逌	youZP
逰	youZQ
貁	youZR
邎	youZS
揄	yuA
扜	yuAM
扝	yuAN
援	yuanA
掾	yuanAB
贠	yuanBM
貟	yuanBN
寃	yuanBO
原	yuanC
辕	yuanCB
螈	yuanCC
轅	yuanCM
蚖	yuanCN
衏	yuanCO
厡	yuanCP
蜎	yuanCQ
輐	yuanCR
蜵	yuanCS
蝯	yuanCT
蝝	yuanCU
厵	yuanCV
剈	yuanDM
源	yuanE
渊	yuanEB
沅	yuanEC
淵	yuanEM
渁	yuanEN
渆	yuanEO
渕	yuanEP
涴	yuanEQ
湲	yuanER
溒	yuanES
灁	yuanET
院	yuanF
缘	yuanFB
緣	yuanFM
邧	yuanFN
縁	yuanFO
弲	yuanGM
鼘	yuanGN
鼝	yuanGO
元	yuanH
橼	yuanI
櫞	yuanIM
杬	yuanIN
棩	yuanIO
楥	yuanIP
榬	yuanIQ
榞	yuanIR
鈨	yuanJM
鋺	yuanJN
鎱	yuanJO
箢	yuanK
笎	yuanKM
裷	yuanKN
裫	yuanKO
褑	yuanKP
褤	yuanKQ
肙	yuanLM
冤	yuanM
鼋	yuanMB
眢	yuanMC
黿	yuanMM
盶	yuanMN
駌	yuanMO
騵	yuanMP
媛	yuanN
鸳	yuanNB
鸢	yuanNC
鴛	yuanNM
鳶	yuanNN
妧	yuanNO
妴	yuanNP
鹓	yuanNQ
媴	yuanNR
嫄	yuanNS
鵷	yuanNT
嬽	yuanNU
鶢	yuanNV
鶰	yuanNW
员	yuanO
員	yuanOM
喛	yuanON
噮	yuanOO
猿	yuanQ
酛	yuanQM
猨	yuanQN
獂	yuanQO
禐	yuanSM
袁	yuanT
垣	yuanTB
塬	yuanTC
垸	yuanTD
円	yuanTM
苑	yuanU
芫	yuanUB
茒	yuanUM
葾	yuanUN
蒝	yuanUO
蒬	yuanUP
薳	yuanUQ
薗	yuanUR
傆	yuanVM
圆	yuanW
园	yuanWB
圜	yuanWC
瑗	yuanWD
園	yuanWM
圓	yuanWN
囦	yuanWO
圎	yuanWP
愿	yuanX
怨	yuanXB
夗	yuanXM
悁	yuanXN
惌	yuanXO
願	yuanYM
魭	yuanYN
羱	yuanYO
謜	yuanYP
远	yuanZ
爰	yuanZB
遠	yuanZM
逺	yuanZN
邍	yuanZO
扵	yuAO
捓	yuAP
挧	yuAQ
捥	yuAR
宇	yuB
寓	yuBB
舆	yuBC
瘀	yuBD
瘐	yuBE
痏	yuBM
寙	yuBN
瘉	yuBO
癒	yuBP
御	yuC
尉	yuCB
蜮	yuCC
蝓	yuCD
龉	yuCE
輿	yuCM
蟈	yuCN
齬	yuCO
虶	yuCP
輍	yuCQ
蜟	yuCR
蝺	yuCS
螸	yuCT
轝	yuCU
齵	yuCV
奧	yuDM
斞	yuDN
浴	yuE
扚	yueAM
抈	yueAN
捳	yueAO
擽	yueAP
渔	yuEB
兌	yueBM
髺	yueBN
淤	yuEC
蛻	yueCM
軏	yueCN
蚎	yueCO
蚏	yueCP
渝	yuED
刖	yueDL
瀹	yueE
兊	yueEM
泧	yueEN
约	yueF
約	yueFM
戉	yueGM
焆	yueHM
黦	yueHN
爚	yueHO
栎	yueI
樾	yueIB
樂	yueIM
櫟	yueIN
枂	yueIO
楽	yueIP
钥	yueJ
钺	yueJB
鑰	yueJM
鉞	yueJN
鑠	yueJO
鈅	yueJP
鋭	yueJQ
箹	yueKM
篗	yueKN
籆	yueKO
籥	yueKP
籰	yueKQ
月	yueL
臒	yueLM
阅	yueM
粤	yueMB
漁	yuEML
粵	yueMM
閱	yueMN
閲	yueMO
矆	yueMP
汚	yuEN
妜	yueNM
嬳	yueNN
鸑	yueNO
鸙	yueNP
哕	yueO
淢	yuEOL
噦	yueOM
哾	yueON
啘	yueOO
乐	yueP
淯	yuEPL
湡	yuEQ
曰	yueR
滪	yuERL
曱	yueRM
岳	yueS
潏	yuESL
嶽	yueSM
岄	yueSN
礿	yueSO
矱	yueSP
禴	yueSQ
澞	yuET
澦	yuEU
藥	yueUM
蘥	yueUN
灪	yuEV
玥	yueWM
悦	yueX
悅	yueXM
恱	yueXN
说	yueY
龠	yueYB
說	yueYM
説	yueYN
龥	yueYO
越	yueZ
跃	yueZB
躍	yueZM
躒	yueZN
跀	yueZO
趯	yueZP
郁	yuF
於	yuFB
隅	yuFC
纡	yuFD
紆	yuFM
邘	yuFN
陓	yuFO
匬	yuFP
鄅	yuFQ
隃	yuFR
旕	yuFS
隩	yuFT
緎	yuFU
繘	yuFV
旟	yuFW
谷	yuG
庾	yuGB
鬻	yuGC
骬	yuGM
庽	yuGN
戫	yuGO
魊	yuGP
髃	yuGQ
于	yuH
与	yuHB
虞	yuHC
煜	yuHD
熨	yuHE
燠	yuHF
丂	yuHM
亐	yuHN
灹	yuHO
秗	yuHP
焴	yuHQ
稢	yuHR
穀	yuHS
稶	yuHT
燏	yuHU
燰	yuHV
穥	yuHW
爩	yuHX
榆	yuI
杅	yuIM
栯	yuIN
桙	yuIO
棫	yuIP
楰	yuIQ
棜	yuIR
棛	yuIS
楀	yuIT
楡	yuIU
櫲	yuIV
欎	yuIW
欝	yuIX
鬰	yuIY
鬱	yuIZ
钰	yuJ
臾	yuJB
觎	yuJC
舁	yuJD
與	yuJM
鈺	yuJN
覦	yuJO
釪	yuJP
铻	yuJQ
銉	yuJR
鋙	yuJS
鋊	yuJT
錥	yuJU
鍝	yuJV
鐭	yuJW
裕	yuK
竽	yuKB
籲	yuKM
衧	yuKN
袬	yuKO
箊	yuKP
褕	yuKQ
篽	yuKR
籅	yuKS
籞	yuKT
育	yuL
腴	yuLB
禺	yuLC
麌	yuLM
驭	yuM
粥	yuMB
毓	yuMC
盂	yuMD
阈	yuME
馭	yuMM
閾	yuMN
閼	yuMO
粖	yuMP
盓	yuMQ
矞	yuMR
睮	yuMS
騟	yuMT
驈	yuMU
娱	yuN
抎	yunAM
抣	yunAN
匀	yunB
妤	yuNBL
勻	yunBM
疺	yunBN
貟	yunBO
賱	yunBP
赟	yunBQ
贇	yunBR
妪	yuNC
蝹	yunCM
蜵	yunCN
轀	yunCO
齫	yunCP
齳	yunCQ
殒	yunD
鹬	yuNDL
殞	yunDM
夽	yunDN
奫	yunDO
允	yunE
鹆	yuNEL
沄	yunEM
涢	yunEN
涒	yunEO
溳	yunEP
澐	yunEQ
陨	yunF
纭	yunFB
郓	yunFC
郧	yunFD
鄖	yunFM
隕	yunFN
紜	yunFO
鄆	yunFP
阭	yunFQ
耺	yunFR
缊	yunFS
緼	yunFT
緷	yunFU
縜	yunFV
縕	yunFW
繧	yunFX
鞰	yunGM
云	yunH
熨	yunHB
秐	yunHM
煴	yunHN
煇	yunHO
熉	yunHP
煾	yunHQ
熅	yunHR
枟	yunIM
榅	yunIN
橒	yunIO
鈗	yunJM
鋆	yunJN
筠	yunK
筼	yunKM
褞	yunKN
篔	yunKO
耘	yunL
腪	yunLM
娛	yuNM
眃	yunMM
馻	yunMN
嫗	yuNN
媼	yunNM
妘	yunNN
员	yunO
鵒	yuNOL
員	yunOM
喗	yunON
鷸	yuNP
磒	yunPM
酝	yunQ
氲	yunQB
狁	yunQC
娪	yuNQL
醞	yunQM
氳	yunQN
醖	yunQO
晕	yunR
昀	yunRB
娯	yuNRL
雲	yunRM
暈	yunRN
霣	yunRO
媀	yuNS
餫	yunSM
媮	yuNT
畇	yunTM
芸	yunU
蕴	yunUB
婾	yuNUL
蘊	yunUM
蕓	yunUN
荺	yunUO
蒀	yunUP
蒷	yunUQ
蒕	yunUR
蕰	yunUS
薀	yunUT
藴	yunUU
鳿	yuNV
伝	yunVM
傊	yunVN
韫	yunW
鴥	yuNWL
韞	yunWM
囩	yunWN
玧	yunWO
韗	yunWP
愠	yunX
恽	yunXB
鴪	yuNXL
鷠	yuNXLL
惲	yunXM
慍	yunXN
愪	yunXO
馧	yunXP
韵	yunY
鴧	yuNYL
鸆	yuNYLL
韻	yunYM
頵	yunYN
运	yunZ
孕	yunZB
嬩	yuNZL
鸒	yuNZLL
運	yunZM
喻	yuO
吁	yuOB
喁	yuOC
唹	yuOM
喅	yuON
喩	yuOO
噊	yuOP
噳	yuOQ
禹	yuP
丿	yuPB
砡	yuPM
硢	yuPN
硲	yuPO
牏	yuPP
礇	yuPQ
礖	yuPR
礜	yuPS
欲	yuQ
狱	yuQB
狳	yuQC
欤	yuQD
獄	yuQM
歟	yuQN
欥	yuQO
酑	yuQP
歈	yuQQ
獝	yuQR
醧	yuQS
雨	yuR
昱	yuRB
雩	yuRC
兪	yuRM
霱	yuRN
豫	yuS
屿	yuSB
馀	yuSC
峪	yuSD
嵛	yuSE
饫	yuSF
嶼	yuSM
禦	yuSN
崳	yuSO
飫	yuSP
餘	yuSQ
彧	yuSR
峿	yuSS
祤	yuST
嵎	yuSU
罭	yuSV
嶎	yuSW
饇	yuSX
軉	yuSY
域	yuT
畲	yuTB
畬	yuTM
圫	yuTN
堉	yuTO
堣	yuTP
堬	yuTQ
畭	yuTR
芋	yuU
蔚	yuUB
菸	yuUC
蓣	yuUD
萸	yuUE
蕷	yuUM
芌	yuUN
茰	yuUO
荢	yuUP
茟	yuUQ
萭	yuUR
萮	yuUS
蒮	yuUT
薁	yuUU
蓹	yuUV
蕍	yuUW
藇	yuUX
蘛	yuUY
蘌	yuUZ
余	yuV
予	yuVB
俞	yuVC
俣	yuVD
伛	yuVE
俁	yuVM
傴	yuVN
伃	yuVO
俼	yuVP
偊	yuVQ
僪	yuVR
儥	yuVS
玉	yuW
瑜	yuWB
圉	yuWC
圄	yuWD
玗	yuWM
玙	yuWN
敔	yuWO
琙	yuWP
琟	yuWQ
瑀	yuWR
璵	yuWS
斔	yuWT
愈	yuX
愚	yuXB
愉	yuXC
窳	yuXD
窬	yuXE
忬	yuXM
穻	yuXN
悇	yuXO
悆	yuXP
惐	yuXQ
慾	yuXR
懙	yuXS
语	yuY
鱼	yuYB
预	yuYC
羽	yuYD
誉	yuYE
聿	yuYF
谕	yuYG
谀	yuYH
肀	yuYI
魚	yuYM
預	yuYN
語	yuYO
譽	yuYP
諛	yuYQ
諭	yuYR
叞	yuYS
翑	yuYT
魣	yuYU
羭	yuYV
鯲	yuYVL
頨	yuYW
鰅	yuYWL
顒	yuYX
鱊	yuYXL
鮽	yuYY
鱮	yuYYL
謣	yuYZ
龥	yuYZL
遇	yuZ
逾	yuZB
迂	yuZC
貍	yuZM
込	yuZN
迃	yuZO
逳	yuZP
艅	yuZQ
歶	yuZR
雓	yuZS
遹	yuZT
踰	yuZU
貐	yuZV
貗	yuZW
雤	yuZX
扎	zaA
拶	zaAB
沞	zaEM
沯	zaEN
匝	zaF
紮	zaFM
紥	zaFN
杂	zaI
扗	zaiAM
抂	zaiAN
宰	zaiB
賳	zaiBM
载	zaiC
載	zaiCM
洅	zaiEM
渽	zaiEN
溨	zaiEO
縡	zaiFM
灾	zaiH
災	zaiHM
烖	zaiHN
栽	zaiI
桚	zaIM
睵	zaiMM
橴	zaIN
哉	zaiO
酨	zaiQM
崽	zaiS
岾	zaiSM
在	zaiT
再	zaiTB
甾	zaiTC
畠	zaiTM
菑	zaiUM
仔	zaiV
傤	zaiVM
儎	zaiVN
子	zaiZ
帀	zaJM
鉔	zaJN
襍	zaKM
臜	zaLM
臢	zaLN
攒	zanA
拶	zanAB
攢	zanAM
揝	zanAN
撍	zanAO
攅	zanAP
赞	zanB
贊	zanBM
寁	zanBN
賛	zanBO
兂	zanEM
濽	zanEN
灒	zanEO
鄼	zanFM
酂	zanFN
酇	zanFO
赃	zangB
贓	zangBM
賍	zangBN
賘	zangBO
贜	zangBP
奘	zangD
匨	zangFM
臧	zangG
弉	zangGM
髒	zangGN
欌	zangIM
銺	zangJM
脏	zangL
臟	zangLM
臓	zangLN
驵	zangM
駔	zangMM
牂	zangPM
塟	zangTM
藏	zangU
葬	zangUB
蔵	zangUM
羘	zangYM
穳	zanHM
桚	zanIM
橵	zanIN
錾	zanJ
鏨	zanJM
鏩	zanJN
鐟	zanJO
鐕	zanJP
篸	zanKM
襸	zanKN
臢	zanLM
糌	zanM
鵤	zanNM
咱	zanO
喒	zanOM
噆	zanON
囋	zanOO
暂	zanR
簪	zanRB
昝	zanRC
暫	zanRM
簮	zanRN
禶	zanSM
饡	zanSN
塹	zanTM
偺	zanVM
儧	zanVN
儹	zanVO
瓒	zanW
瓚	zanWM
瓉	zanWN
讃	zanYM
讚	zanYN
趱	zanZ
趲	zanZM
蹔	zanZN
咋	zaO
咂	zaOB
皂	zaoBL
皁	zaoBM
蚤	zaoC
澡	zaoE
繅	zaoFM
繰	zaoFN
燥	zaoH
灶	zaoHB
煰	zaoHM
枣	zaoI
棗	zaoIM
栆	zaoIN
梍	zaoIO
鑿	zaoJM
凿	zaoK
簉	zaoKM
糟	zaoM
喒	zaOML
噈	zaON
噪	zaoO
唣	zaoOB
囃	zaOOL
唕	zaoOM
喿	zaoON
囋	zaOP
囐	zaOQ
醩	zaoQM
早	zaoR
藻	zaoU
薻	zaoUM
傮	zaoVM
璅	zaoWM
璪	zaoWN
竈	zaoXM
慥	zaoXN
竃	zaoXO
謲	zaoYM
譟	zaoYN
造	zaoZ
遭	zaoZB
躁	zaoZC
艁	zaoZM
蹧	zaoZN
趮	zaoZO
砸	zaP
磼	zaPM
偺	zaVM
韴	zaYM
魳	zaYN
雜	zaZM
雑	zaZN
雥	zaZO
择	zeA
擇	zeAM
択	zeAN
捑	zeAO
责	zeB
赜	zeBB
責	zeBM
賾	zeBN
皟	zeBO
仄	zeC
厠	zeCM
蠌	zeCN
齚	zeCO
齰	zeCP
则	zeD
則	zeDM
泽	zeE
澤	zeEM
汄	zeEN
沢	zeEO
泎	zeEP
溭	zeEQ
滜	zeER
灂	zeES
庂	zeGM
稄	zeHM
贼	zeiB
賊	zeiBM
蠈	zeiCM
戝	zeiGM
樍	zeIM
鯽	zeiYM
鲗	zeiYN
鰂	zeiYO
鱡	zeiYP
帻	zeJ
幘	zeJM
笮	zeK
箦	zeKB
簀	zeKM
襗	zeKN
耫	zeLM
睪	zeMM
矠	zeMN
瞔	zeMO
撍	zenAM
赠	zengB
贈	zengBM
综	zengF
缯	zengFB
綜	zengFM
繒	zengFN
鄫	zengFO
縡	zengFP
鬵	zengGM
熷	zengHM
橧	zengIM
锃	zengJ
鋥	zengJM
竲	zengLM
囎	zengOM
磳	zengPM
曾	zengR
曽	zengRM
罾	zengS
矰	zengSM
增	zengT
増	zengTM
甑	zengW
璔	zengWM
憎	zengX
譄	zengYM
鱛	zengYN
嫧	zeNM
鸅	zeNN
囎	zenOM
怎	zenX
谮	zenY
譖	zenYM
譛	zenYN
啧	zeO
咋	zeOB
嘖	zeOM
啫	zeON
唶	zeOO
礋	zePM
昃	zeR
昗	zeRM
崱	zeSM
飵	zeSN
蔶	zeUM
蘀	zeUN
侧	zeV
側	zeVM
伬	zeVN
諎	zeYM
謮	zeYN
舴	zeZ
迮	zeZB
歵	zeZM
扎	zhaA
揸	zhaAB
摣	zhaAM
扠	zhaAN
抯	zhaAO
拃	zhaAP
挓	zhaAQ
挿	zhaAR
揷	zhaAS
搾	zhaAT
痄	zhaB
齄	zhaBB
齇	zhaBM
宱	zhaBN
轧	zhaC
蚱	zhaCB
蜡	zhaCC
軋	zhaCM
蠟	zhaCN
齟	zhaCO
厏	zhaCP
蚻	zhaCQ
齰	zhaCR
劄	zhaDM
奓	zhaDN
剳	zhaDO
渣	zhaE
溠	zhaEM
潳	zhaEN
紮	zhaFM
紥	zhaFN
鞢	zhaGM
炸	zhaH
灹	zhaHM
煠	zhaHN
栅	zhaI
摘	zhaiA
择	zhaiAB
擇	zhaiAM
択	zhaiAN
抧	zhaiAO
捚	zhaiAP
擿	zhaiAQ
寨	zhaiB
宅	zhaiBB
瘵	zhaiBC
札	zhaIBL
責	zhaiBM
榨	zhaIC
厇	zhaiCM
厏	zhaiCN
查	zhaID
柞	zhaIE
亝	zhaiEM
楂	zhaIF
骴	zhaiGM
榸	zhaiIM
檡	zhaiIN
鉙	zhaiJM
簀	zhaiKM
柵	zhaIM
駘	zhaiMM
粂	zhaiMN
柤	zhaIN
哜	zhaiO
査	zhaIOL
嚌	zhaiOM
砦	zhaiP
樝	zhaIPL
齋	zhaiQM
债	zhaiV
侧	zhaiVB
側	zhaiVM
債	zhaiVN
斋	zhaiW
斎	zhaiWM
窄	zhaiX
翟	zhaiY
夈	zhaiZM
铡	zhaJ
鍘	zhaJM
觰	zhaJN
箚	zhaKM
耫	zhaLM
眨	zhaM
闸	zhaMB
閘	zhaMM
搌	zhanA
占	zhanB
辗	zhanC
輾	zhanCM
蛅	zhanCN
輚	zhanCO
轏	zhanCP
沾	zhanE
湛	zhanEB
绽	zhanF
旃	zhanFB
綻	zhanFM
飐	zhanFN
颭	zhanFO
旜	zhanFP
战	zhanG
掌	zhangA
扙	zhangAM
账	zhangB
瘴	zhangBB
賬	zhangBM
痮	zhangBN
瘬	zhangBO
长	zhangC
蟑	zhangCB
長	zhangCM
兏	zhangCN
涨	zhangE
漳	zhangEB
漲	zhangEM
涱	zhangEN
障	zhangF
鄣	zhangFB
张	zhangG
張	zhangGM
弡	zhangGN
鞝	zhangGO
丈	zhangH
杖	zhangI
樟	zhangIB
帐	zhangJ
幛	zhangJB
帳	zhangJM
幥	zhangJN
鏱	zhangJO
章	zhangL
胀	zhangLB
脹	zhangLM
麞	zhangLN
戰	zhanGM
粀	zhangMM
粻	zhangMN
瞕	zhangMO
騿	zhangMP
嫜	zhangN
戦	zhanGNL
魙	zhanGO
礃	zhangPM
獐	zhangQ
暲	zhangRM
彰	zhangS
嶂	zhangSB
餦	zhangSM
墇	zhangTM
蔁	zhangUM
仗	zhangV
仉	zhangVB
仧	zhangVM
傽	zhangVN
璋	zhangW
慞	zhangXM
鱆	zhangYM
遧	zhangZM
虦	zhanHM
虥	zhanHN
黵	zhanHO
栈	zhanI
棧	zhanIM
枬	zhanIN
桟	zhanIO
栴	zhanIP
榐	zhanIQ
橏	zhanIR
欃	zhanIS
斩	zhanJ
斬	zhanJM
覱	zhanJN
襢	zhanKM
站	zhanL
粘	zhanM
盏	zhanMB
瞻	zhanMC
毡	zhanMD
盞	zhanMM
氈	zhanMN
驏	zhanMO
閚	zhanMP
氊	zhanMQ
驙	zhanMR
鳽	zhanNM
嫸	zhanNN
鹯	zhanNO
鸇	zhanNP
噡	zhanOM
展	zhanP
碊	zhanPM
皽	zhanPN
醆	zhanQM
霑	zhanRM
崭	zhanS
嶄	zhanSM
飦	zhanSN
嵁	zhanSO
嶃	zhanSP
嶘	zhanSQ
嶦	zhanSR
餰	zhanSS
饘	zhanST
蘸	zhanU
菚	zhanUM
薝	zhanUN
佔	zhanVM
偡	zhanVN
僝	zhanVO
琖	zhanWM
怗	zhanXM
惉	zhanXN
詹	zhanY
颤	zhanYB
谵	zhanYC
顫	zhanYM
譫	zhanYN
詀	zhanYO
譧	zhanYP
鳣	zhanYQ
鱣	zhanYR
讝	zhanYS
趈	zhanZM
跕	zhanZN
邅	zhanZO
咋	zhaO
找	zhaoA
招	zhaoAB
喳	zhaOB
吒	zhaOC
喋	zhaOD
兆	zhaoE
沼	zhaoEB
咤	zhaOEL
哳	zhaOF
罀	zhaoFM
旐	zhaoFN
照	zhaoH
炤	zhaoHM
燳	zhaoHN
棹	zhaoI
枛	zhaoIM
櫂	zhaoIN
钊	zhaoJ
釗	zhaoJM
釽	zhaoJN
鉊	zhaoJO
鍣	zhaoJP
笊	zhaoK
箌	zhaoKM
朝	zhaoL
着	zhaoM
啑	zhaOML
盄	zhaoMM
鼌	zhaoMN
駋	zhaoMO
瞾	zhaoMP
鼂	zhaoMQ
喥	zhaON
妱	zhaoNM
鳭	zhaoNN
召	zhaoO
嘲	zhaoOB
啁	zhaoOC
囃	zhaOOL
啅	zhaoOM
皽	zhaoPM
狣	zhaoQM
昭	zhaoR
曌	zhaoRM
罩	zhaoS
巶	zhaoSM
羄	zhaoSN
垗	zhaoTM
菬	zhaoUM
佋	zhaoVM
瑵	zhaoWM
肇	zhaoY
诏	zhaoYB
詔	zhaoYM
肁	zhaoYN
肈	zhaoYO
鮡	zhaoYP
謿	zhaoYQ
赵	zhaoZ
爪	zhaoZB
趙	zhaoZM
爫	zhaoZN
乍	zhaP
砟	zhaPB
牐	zhaPM
皶	zhaPN
皻	zhaPO
醡	zhaQM
霅	zhaRM
飵	zhaSM
苲	zhaUM
蔖	zhaUN
偞	zhaVM
偧	zhaVN
诈	zhaY
詐	zhaYM
鰈	zhaYN
鲊	zhaYO
鲝	zhaYP
諎	zhaYQ
鮓	zhaYR
鮺	zhaYS
譇	zhaYT
譗	zhaYU
折	zheA
摺	zheAB
扸	zheAM
摂	zheAN
搩	zheAO
辙	zheC
蛰	zheCB
辄	zheCC
蜇	zheCD
赭	zheCE
螫	zheCF
蟄	zheCM
轍	zheCN
輒	zheCO
厇	zheCP
虴	zheCQ
輙	zheCR
蟅	zheCS
歽	zheDM
浙	zheE
淛	zheEM
聑	zheFM
柘	zheI
杔	zheIM
棏	zheIN
樜	zheIO
这	zheiZ
這	zheiZM
锗	zheJ
鍺	zheJM
銸	zheJN
褶	zheK
袩	zheKM
襵	zheKN
者	zheL
着	zheM
籷	zheMM
粍	zheMN
馲	zheMO
鹧	zheN
振	zhenA
抮	zhenAM
挋	zhenAN
揕	zhenAO
搸	zhenAP
贞	zhenB
赈	zhenBB
疹	zhenBC
貞	zhenBM
賑	zhenBN
寊	zhenBO
鬒	zhenBP
轸	zhenC
軫	zhenCM
蜄	zhenCN
轃	zhenCO
辴	zhenCP
斟	zhenD
殝	zhenDM
溱	zhenE
浈	zhenEB
湞	zhenEM
沴	zhenEN
潧	zhenEO
澵	zhenEP
阵	zhenF
缜	zhenFB
陣	zhenFM
縝	zhenFN
纼	zhenFO
紖	zhenFP
聄	zhenFQ
紾	zhenFR
絼	zhenFS
縥	zhenFT
挣	zhengA
拯	zhengAB
掙	zhengAM
抍	zhengAN
掟	zhengAO
揁	zhengAP
撜	zhengAQ
症	zhengB
癥	zhengBM
鬇	zhengBN
征	zhengC
徵	zhengCB
徎	zhengCM
徰	zhengCN
徴	zhengCO
争	zhengD
湞	zhengEM
氶	zhengEN
浧	zhengEO
郑	zhengF
鄭	zhengFM
糽	zhengFN
聇	zhengFO
綪	zhengFP
丁	zhengH
炡	zhengHM
烝	zhengHN
铮	zhengJ
钲	zhengJB
幀	zhengJM
鉦	zhengJN
錚	zhengJO
凧	zhengJP
幁	zhengJQ
鏳	zhengJR
筝	zhengK
箏	zhengKM
篜	zhengKN
脀	zhengLM
睁	zhengM
弫	zhenGML
睜	zhengMM
眐	zhengMN
姃	zhengNM
媜	zhengNN
鴊	zhengNO
狰	zhengQ
猙	zhengQM
靕	zhengQN
晸	zhengRM
峥	zhengS
崢	zhengSM
崝	zhengSN
埩	zhengTM
埥	zhengTN
塣	zhengTO
蒸	zhengU
倀	zhengVM
佂	zhengVN
政	zhengW
整	zhengWB
怔	zhengX
愸	zhengXM
憕	zhengXN
证	zhengY
诤	zhengYB
證	zhengYM
諍	zhengYN
鯖	zhengYO
証	zhengYP
鮏	zhengYQ
正	zhengZ
爭	zhengZM
踭	zhengZN
稹	zhenH
黰	zhenHM
枕	zhenI
桢	zhenIB
榛	zhenIC
椹	zhenID
楨	zhenIM
朾	zhenIN
枮	zhenIO
栚	zhenIP
桭	zhenIQ
槙	zhenIR
槇	zhenIS
榐	zhenIT
樼	zhenIU
镇	zhenJ
针	zhenJB
帧	zhenJC
針	zhenJM
幀	zhenJN
鎮	zhenJO
帪	zhenJP
鈂	zhenJQ
覙	zhenJR
鉁	zhenJS
鋴	zhenJT
錱	zhenJU
鍖	zhenJV
鍼	zhenJW
鎭	zhenJX
箴	zhenK
袗	zhenKM
裖	zhenKN
籈	zhenKO
朕	zhenL
胗	zhenLB
竧	zhenLM
鷓	zheNM
眕	zhenMM
眞	zhenMN
眹	zhenMO
駗	zhenMP
鸩	zhenN
嫬	zheNNL
鴆	zhenNM
姫	zhenNN
嫃	zhenNO
砧	zhenP
屒	zhenPM
碪	zhenPN
酙	zhenQM
靕	zhenQN
獉	zhenQO
震	zhenR
昣	zhenRM
真	zhenS
祯	zhenSB
禎	zhenSM
禛	zhenSN
圳	zhenT
畛	zhenTB
甽	zhenTM
塦	zhenTN
塡	zhenTO
蓁	zhenU
萙	zhenUM
葴	zhenUN
蒖	zhenUO
薽	zhenUP
侦	zhenV
偵	zhenVM
侲	zhenVN
珍	zhenW
甄	zhenWB
珎	zhenWM
瑧	zhenWN
瑱	zhenWO
敶	zhenWP
诊	zhenY
診	zhenYM
誫	zhenYN
謓	zhenYO
鱵	zhenYP
臻	zhenZ
遉	zhenZM
哲	zheO
囁	zheOM
啠	zheON
喆	zheOO
嗻	zheOP
嚞	zheOQ
磔	zheP
乇	zhePB
矺	zhePM
砓	zhePN
晢	zheRM
晣	zheRN
埑	zheTM
蔗	zheU
乽	zheVM
悊	zheXM
慹	zheXN
谪	zheY
謫	zheYM
詟	zheYN
謺	zheYO
鮿	zheYP
讁	zheYQ
讋	zheYR
这	zheZ
遮	zheZB
夂	zheZC
這	zheZM
踷	zheZN
指	zhiA
执	zhiAB
掷	zhiAC
挚	zhiAD
摭	zhiAE
摯	zhiAM
擲	zhiAN
扺	zhiAO
扻	zhiAP
抧	zhiAQ
挃	zhiAR
捗	zhiAS
搘	zhiAT
搱	zhiAU
摕	zhiAV
摨	zhiAW
擳	zhiAX
擿	zhiAY
质	zhiB
贽	zhiBB
痣	zhiBC
痔	zhiBD
質	zhiBM
贄	zhiBN
疻	zhiBO
疷	zhiBP
貭	zhiBQ
痓	zhiBR
寘	zhiBS
瘈	zhiBT
蜘	zhiC
徵	zhiCB
蛭	zhiCC
轾	zhiCD
轵	zhiCE
軹	zhiCM
輊	zhiCN
厔	zhiCO
蚔	zhiCP
徏	zhiCQ
徝	zhiCR
軽	zhiCS
徴	zhiCT
螲	zhiCU
蟙	zhiCV
之	zhiD
制	zhiDB
殖	zhiDC
剬	zhiDM
劕	zhiDN
豑	zhiDO
治	zhiE
滞	zhiEB
汁	zhiEC
滯	zhiEM
汥	zhiEN
沚	zhiEO
汦	zhiEP
泜	zhiEQ
洔	zhiER
洷	zhiES
淽	zhiET
淔	zhiEU
滍	zhiEV
潌	zhiEW
漐	zhiEX
潪	zhiEY
瀄	zhiEZ
职	zhiF
织	zhiFB
纸	zhiFC
絷	zhiFD
陟	zhiFE
郅	zhiFF
紙	zhiFM
職	zhiFN
織	zhiFO
縶	zhiFP
酈	zhiFQ
阤	zhiFR
阯	zhiFS
聀	zhiFT
紩	zhiFU
綕	zhiFV
絺	zhiFW
聜	zhiFX
旘	zhiFY
緻	zhiFYL
隲	zhiFZ
豒	zhiFZL
庤	zhiGM
庢	zhiGN
戠	zhiGO
瓡	zhiGP
廌	zhiGQ
稚	zhiH
秩	zhiHB
炙	zhiHC
亊	zhiHM
秇	zhiHN
秓	zhiHO
秖	zhiHP
秪	zhiHQ
秲	zhiHR
秷	zhiHS
稙	zhiHT
稺	zhiHU
熫	zhiHV
穉	zhiHW
枝	zhiI
植	zhiIB
桎	zhiIC
栉	zhiID
栀	zhiIE
枳	zhiIF
梔	zhiIM
櫛	zhiIN
杝	zhiIO
杫	zhiIP
柣	zhiIQ
栺	zhiIR
梽	zhiIS
楖	zhiIT
椥	zhiIU
榰	zhiIV
槯	zhiIW
樀	zhiIX
樲	zhiIY
樴	zhiIZ
櫍	zhiIZL
帜	zhiJ
觯	zhiJB
卮	zhiJC
帙	zhiJD
幟	zhiJM
觶	zhiJN
凪	zhiJO
帋	zhiJP
斦	zhiJQ
釞	zhiJR
铚	zhiJS
觗	zhiJT
觝	zhiJU
锧	zhiJV
鉄	zhiJW
覟	zhiJX
銍	zhiJY
鋕	zhiJYL
銴	zhiJZ
鑕	zhiJZL
衼	zhiKM
衹	zhiKN
袟	zhiKO
袠	zhiKP
筫	zhiKQ
製	zhiKR
襧	zhiKS
肢	zhiL
脂	zhiLB
膣	zhiLC
胝	zhiLD
劧	zhiLM
胑	zhiLN
胵	zhiLO
膱	zhiLP
骘	zhiM
騭	zhiMM
眰	zhiMN
馶	zhiMO
馽	zhiMP
駤	zhiMQ
驇	zhiMR
騺	zhiMS
鼅	zhiMT
鸷	zhiN
鷙	zhiNM
妷	zhiNN
姪	zhiNO
娡	zhiNP
犆	zhiNQ
媞	zhiNR
鳷	zhiNS
嬂	zhiNT
鴙	zhiNU
鴲	zhiNV
鶨	zhiNW
只	zhiO
吱	zhiOB
呮	zhiOM
嚔	zhiON
咫	zhiP
砋	zhiPM
礩	zhiPN
酯	zhiQ
狾	zhiQM
猘	zhiQN
智	zhiR
旨	zhiRB
晊	zhiRM
知	zhiS
直	zhiSB
置	zhiSC
峙	zhiSD
氏	zhiSE
祗	zhiSF
祉	zhiSG
彘	zhiSH
巵	zhiSM
祇	zhiSN
祑	zhiSO
祬	zhiSP
崻	zhiSQ
禃	zhiSR
禔	zhiSS
軄	zhiST
址	zhiT
埴	zhiTB
執	zhiTM
坁	zhiTN
坧	zhiTO
垁	zhiTP
畤	zhiTQ
墆	zhiTR
墌	zhiTS
芝	zhiU
芷	zhiUB
芖	zhiUM
茋	zhiUN
茝	zhiUO
菭	zhiUP
薙	zhiUQ
藢	zhiUR
蘵	zhiUS
值	zhiV
侄	zhiVB
伿	zhiVM
俧	zhiVN
値	zhiVO
倁	zhiVP
偫	zhiVQ
乿	zhiVR
傂	zhiVS
儨	zhiVT
致	zhiW
璏	zhiWM
瓆	zhiWN
志	zhiX
窒	zhiXB
忮	zhiXC
夛	zhiXM
恉	zhiXN
慹	zhiXO
憄	zhiXP
懥	zhiXQ
懫	zhiXR
识	zhiY
黹	zhiYB
誌	zhiYM
識	zhiYN
訨	zhiYO
翐	zhiYP
謢	zhiYQ
鯯	zhiYR
支	zhiZ
至	zhiZB
止	zhiZC
趾	zhiZD
雉	zhiZE
跖	zhiZF
豸	zhiZG
踯	zhiZH
踬	zhiZI
隻	zhiZM
躑	zhiZN
躓	zhiZO
迣	zhiZP
歭	zhiZQ
雙	zhiZR
臷	zhiZS
臸	zhiZT
跱	zhiZU
疐	zhiZV
蹛	zhiZW
蹠	zhiZX
蹢	zhiZY
瘇	zhongBM
螽	zhongC
彸	zhongCM
蚛	zhongCN
蜙	zhongCO
蝩	zhongCP
徸	zhongCQ
螤	zhongCR
刣	zhongDM
汷	zhongEM
泈	zhongEN
终	zhongF
終	zhongFM
緟	zhongFN
种	zhongH
種	zhongHM
炂	zhongHN
煄	zhongHO
穜	zhongHP
柊	zhongIM
钟	zhongJ
锺	zhongJB
鐘	zhongJM
鍾	zhongJN
鈡	zhongJO
鈆	zhongJP
幒	zhongJQ
銿	zhongJR
衷	zhongK
衶	zhongKM
衳	zhongKN
筗	zhongKO
籦	zhongKP
中	zhongL
肿	zhongLB
腫	zhongLM
冢	zhongM
盅	zhongMB
眾	zhongMM
妕	zhongNM
妐	zhongNN
媑	zhongNO
鴤	zhongNP
喠	zhongOM
重	zhongP
狆	zhongQM
祌	zhongSM
鼨	zhongSN
堹	zhongTM
塚	zhongTN
茽	zhongUM
蔠	zhongUN
众	zhongV
仲	zhongVB
伀	zhongVM
偅	zhongVN
斔	zhongWM
忠	zhongX
忪	zhongXB
衆	zhongXM
尰	zhongYM
諥	zhongYN
踵	zhongZ
舯	zhongZB
夂	zhongZC
迚	zhongZM
歱	zhongZN
蹱	zhongZO
掫	zhouAM
宙	zhouB
疛	zhouBM
赒	zhouBN
賙	zhouBO
州	zhouC
轴	zhouCB
軸	zhouCM
辀	zhouCN
徟	zhouCO
輈	zhouCP
輖	zhouCQ
洲	zhouE
洀	zhouEM
淍	zhouEN
纣	zhouF
繇	zhouFB
绉	zhouFC
紂	zhouFM
縐	zhouFN
郮	zhouFO
紬	zhouFP
炿	zhouHM
烐	zhouHN
椆	zhouIM
帚	zhouJ
鈾	zhouJM
箒	zhouJN
銂	zhouJO
籀	zhouK
籕	zhouKM
籒	zhouKN
肘	zhouL
胄	zhouLB
胕	zhouLM
骤	zhouM
粥	zhouMB
驟	zhouMM
粙	zhouMN
睭	zhouMO
駎	zhouMP
駲	zhouMQ
盩	zhouMR
騆	zhouMS
妯	zhouN
鸼	zhouNM
婤	zhouNN
鵃	zhouNO
周	zhouO
咒	zhouOB
啁	zhouOC
呪	zhouOM
咮	zhouON
喌	zhouOO
噣	zhouOP
嚋	zhouOQ
皱	zhouP
碡	zhouPB
皺	zhouPM
酎	zhouQ
昼	zhouR
晝	zhouRM
晭	zhouRN
霌	zhouRO
矪	zhouSM
冑	zhouTM
荮	zhouU
葤	zhouUM
菷	zhouUN
薵	zhouUO
伷	zhouVM
侜	zhouVN
僽	zhouVO
珘	zhouWM
甃	zhouWN
诌	zhouY
調	zhouYM
謅	zhouYN
诪	zhouYO
詋	zhouYP
詶	zhouYQ
翢	zhouYR
鯞	zhouYS
譸	zhouYT
舟	zhouZ
週	zhouZM
拄	zhuA
抓	zhuaA
挝	zhuaAB
撾	zhuaAM
髽	zhuaBM
蛀	zhuaC
拽	zhuaiA
捙	zhuaiAM
轉	zhuaiCM
檛	zhuaIM
睉	zhuaiMM
跩	zhuaiZM
簻	zhuaKM
膼	zhuaLM
瞩	zhuaM
拀	zhuAML
撰	zhuanA
摶	zhuanAM
赚	zhuanB
賺	zhuanBM
转	zhuanC
專	zhuanCM
轉	zhuanCN
専	zhuanCO
転	zhuanCP
蟤	zhuanCQ
剸	zhuanDM
耑	zhuanEM
漙	zhuanEN
鄟	zhuanFM
縳	zhuanFN
撞	zhuangA
奘	zhuangD
湷	zhuangEM
漴	zhuangEN
庄	zhuangG
庒	zhuangGM
焋	zhuangHM
桩	zhuangI
樁	zhuangIM
梉	zhuangIN
幢	zhuangJ
装	zhuangK
裝	zhuangKM
粧	zhuangMM
糚	zhuangMN
妆	zhuangN
妝	zhuangNM
娤	zhuangNN
壮	zhuangP
状	zhuangQ
狀	zhuangQM
獞	zhuangQN
壯	zhuangSM
壵	zhuangSN
莊	zhuangUM
荘	zhuangUN
僮	zhuangV
戆	zhuangX
戇	zhuangXM
戅	zhuangXN
专	zhuanH
灷	zhuanHM
篆	zhuanK
篹	zhuanKM
篿	zhuanKN
襈	zhuanKO
簨	zhuanKP
籑	zhuanKQ
腞	zhuanLM
膞	zhuanLN
竱	zhuanLO
嫥	zhuanNM
啭	zhuanO
囀	zhuanOM
砖	zhuanP
磚	zhuanPM
磗	zhuanPN
馔	zhuanS
饌	zhuanSM
叀	zhuanSN
堟	zhuanTM
塼	zhuanTN
蒃	zhuanUM
传	zhuanV
傳	zhuanVM
僝	zhuanVN
僎	zhuanVO
瑑	zhuanWM
瑼	zhuanWN
甎	zhuanWO
恮	zhuanXM
颛	zhuanY
顓	zhuanYM
諯	zhuanYN
譔	zhuanYO
鱄	zhuanYP
孨	zhuanZM
爪	zhuaZ
爫	zhuaZM
贮	zhuB
瘃	zhuBB
疰	zhuBC
貯	zhuBM
寧	zhuBN
宔	zhuBO
癷	zhuBP
蛛	zhuC
蛀	zhuCB
術	zhuCM
虲	zhuCN
尌	zhuCO
軴	zhuCP
徚	zhuCQ
蝫	zhuCR
蝊	zhuCS
蠋	zhuCT
蠩	zhuCU
蠾	zhuCV
主	zhuD
丶	zhuDB
劚	zhuDM
注	zhuE
渚	zhuEB
洙	zhuEC
潴	zhuED
瀦	zhuEM
泏	zhuEN
濐	zhuEO
灟	zhuEP
邾	zhuF
纻	zhuFM
聁	zhuFN
陼	zhuFO
紸	zhuFP
紵	zhuFQ
絑	zhuFR
庻	zhuGM
煮	zhuH
烛	zhuHB
炷	zhuHC
燭	zhuHM
炢	zhuHN
烪	zhuHO
秼	zhuHP
焑	zhuHQ
煑	zhuHR
稥	zhuHS
燞	zhuHT
燝	zhuHU
爥	zhuHV
朱	zhuI
柱	zhuIB
赘	zhuiBL
贅	zhuiBM
株	zhuIC
轛	zhuiCM
术	zhuID
奞	zhuiDM
杼	zhuIE
沝	zhuiEM
缀	zhuiF
缒	zhuiFB
槠	zhuIFL
隊	zhuiFM
綴	zhuiFN
縋	zhuiFO
橥	zhuIG
椎	zhuiI
锥	zhuiJ
錐	zhuiJM
錣	zhuiJN
鑆	zhuiJO
笍	zhuiKM
箠	zhuiKN
腏	zhuiLM
膇	zhuiLN
骓	zhuiM
櫧	zhuIML
騅	zhuiMM
櫫	zhuIN
娷	zhuiNM
鵻	zhuiNN
朮	zhuIO
柷	zhuIP
硾	zhuiPM
礈	zhuiPN
樦	zhuIQ
醀	zhuiQM
醊	zhuiQN
櫡	zhuIR
欘	zhuIS
餟	zhuiSM
坠	zhuiT
墜	zhuiTM
埀	zhuiTN
畷	zhuiTO
萑	zhuiU
倕	zhuiVM
甀	zhuiWM
惴	zhuiX
諈	zhuiYM
追	zhuiZ
隹	zhuiZB
铸	zhuJ
铢	zhuJB
鑄	zhuJM
銖	zhuJN
帾	zhuJO
鉒	zhuJP
鋳	zhuJQ
鍂	zhuJR
鐢	zhuJS
斸	zhuJT
钃	zhuJU
竹	zhuK
筑	zhuKB
褚	zhuKC
竺	zhuKD
箸	zhuKE
築	zhuKM
笁	zhuKN
笜	zhuKO
袾	zhuKP
袰	zhuKQ
筯	zhuKR
篫	zhuKS
篴	zhuKT
簗	zhuKU
助	zhuL
麈	zhuLB
劯	zhuLM
朑	zhuLN
竚	zhuLO
麆	zhuLP
驻	zhuM
瞩	zhuMB
駐	zhuMM
矚	zhuMN
毜	zhuMO
毝	zhuMP
眝	zhuMQ
毮	zhuMR
馵	zhuMS
駯	zhuMT
鼄	zhuMU
闧	zhuMV
准	zhunB
宒	zhunBM
凖	zhunBN
衠	zhunCM
準	zhunEM
綧	zhunFM
屯	zhunH
稕	zhunHM
肫	zhunL
鴸	zhuNM
鸀	zhuNN
孎	zhuNO
啍	zhunOM
旽	zhunRM
圫	zhunTM
甽	zhunTN
埻	zhunTO
窀	zhunX
忳	zhunXM
谆	zhunY
諄	zhunYM
訰	zhunYN
迍	zhunZM
嘱	zhuO
捉	zhuoA
拙	zhuoAB
擢	zhuoAC
捔	zhuoAM
擆	zhuoAN
撯	zhuoAO
彴	zhuoCM
蝃	zhuoCN
蠗	zhuoCO
蠿	zhuoCP
剢	zhuoDM
劅	zhuoDN
浊	zhuoE
涿	zhuoEB
濯	zhuoEC
浞	zhuoED
濁	zhuoEM
汋	zhuoEN
灂	zhuoEO
缴	zhuoF
繳	zhuoFM
聉	zhuoFN
灼	zhuoH
焯	zhuoHB
炪	zhuoHM
烵	zhuoHN
燋	zhuoHO
穛	zhuoHP
穱	zhuoHQ
桌	zhuoI
梲	zhuoIM
棁	zhuoIN
椓	zhuoIO
棳	zhuoIP
槕	zhuoIQ
櫡	zhuoIR
镯	zhuoJ
鐲	zhuoJM
斱	zhuoJN
斮	zhuoJO
斲	zhuoJP
鋜	zhuoJQ
斵	zhuoJR
鐯	zhuoJS
篧	zhuoKM
籗	zhuoKN
籱	zhuoKO
着	zhuoM
囑	zhuOML
矠	zhuoMM
嗻	zhuON
妰	zhuoNM
娺	zhuoNN
鵫	zhuoNO
鷟	zhuoNP
啄	zhuoO
啅	zhuoOM
噣	zhuoON
斫	zhuoP
硺	zhuoPM
酌	zhuoQ
犳	zhuoQM
晫	zhuoRM
卓	zhuoS
禚	zhuoSB
罬	zhuoSM
圴	zhuoTM
墌	zhuoTN
茁	zhuoU
著	zhuoUB
蓔	zhuoUM
藋	zhuoUN
倬	zhuoV
琢	zhuoW
琸	zhuoWM
斀	zhuoWN
窧	zhuoXM
窡	zhuoXN
诼	zhuoY
諑	zhuoYM
叕	zhuoYN
丵	zhuoYO
諁	zhuoYP
謶	zhuoYQ
趠	zhuoZM
蹠	zhuoZN
属	zhuP
屬	zhuPM
殶	zhuPN
砫	zhuPO
屗	zhuPP
硃	zhuPQ
磩	zhuPR
猪	zhuQ
曢	zhuRM
霻	zhuRN
曯	zhuRO
祝	zhuS
豬	zhuSM
壴	zhuSN
罜	zhuSO
祩	zhuSP
嵀	zhuSQ
飳	zhuSR
坾	zhuTM
墸	zhuTN
著	zhuU
茱	zhuUB
苎	zhuUC
苧	zhuUM
芧	zhuUN
茿	zhuUO
莇	zhuUP
蒊	zhuUQ
蓫	zhuUR
蕏	zhuUS
薴	zhuUT
藸	zhuUU
藷	zhuUV
住	zhuV
侏	zhuVB
伫	zhuVC
佇	zhuVM
乼	zhuVN
珠	zhuW
敱	zhuWM
敳	zhuWN
斀	zhuWO
窋	zhuXM
诸	zhuY
诛	zhuYB
翥	zhuYC
註	zhuYM
誅	zhuYN
諸	zhuYO
羜	zhuYP
詝	zhuYQ
鮢	zhuYR
鯺	zhuYS
鱁	zhuYT
逐	zhuZ
躅	zhuZB
舳	zhuZC
迬	zhuZM
逫	zhuZN
跙	zhuZO
跓	zhuZP
跦	zhuZQ
艈	zhuZR
资	ziB
兹	ziBB
髭	ziBC
赀	ziBD
資	ziBM
貲	ziBN
辎	ziC
龇	ziCB
輜	ziCM
齜	ziCN
虸	ziCO
輺	ziCP
剚	ziDM
鼒	ziDN
滋	ziE
渍	ziEB
淄	ziEC
滓	ziED
漬	ziEM
沝	ziEN
洓	ziEO
湽	ziEP
澬	ziEQ
紫	ziF
缁	ziFB
緇	ziFM
紎	ziFN
鄑	ziFO
緕	ziFP
纃	ziFQ
秭	ziH
秄	ziHM
秶	ziHN
稵	ziHO
穧	ziHP
梓	ziI
杍	ziIM
栥	ziIN
椔	ziIO
榟	ziIP
觜	ziJ
锱	ziJB
錙	ziJM
釨	ziJN
鈭	ziJO
镃	ziJP
鍿	ziJQ
鎡	ziJR
笫	ziK
耔	ziL
胏	ziLM
籽	ziM
眦	ziMB
粢	ziMC
眥	ziMM
姿	ziN
姊	ziNB
姉	ziNM
姕	ziNN
牸	ziNO
鶅	ziNP
呲	ziO
吱	ziOB
咨	ziOC
吇	ziOM
呰	ziON
啙	ziOO
嗞	ziOP
嗭	ziOQ
矷	ziPM
齍	ziQM
胾	ziRM
胔	ziRN
嵫	ziS
崰	ziSM
禌	ziSN
畠	ziTM
茈	ziU
茲	ziUM
芓	ziUN
茊	ziUO
荢	ziUP
茡	ziUQ
菑	ziUR
葘	ziUS
蓻	ziUT
薋	ziUU
仔	ziV
倳	ziVM
璾	ziWM
恣	ziX
玆	ziXM
谘	ziY
訾	ziYB
鲻	ziYC
諮	ziYM
鯔	ziYN
訿	ziYO
頾	ziYP
頿	ziYQ
鰦	ziYR
子	ziZ
自	ziZB
字	ziZC
孜	ziZD
孳	ziZE
趑	ziZF
孖	ziZM
赼	ziZN
孶	ziZO
趦	ziZP
捴	zongAM
揌	zongAN
揔	zongAO
搃	zongAP
摠	zongAQ
宗	zongB
鬃	zongBB
疭	zongBM
瘲	zongBN
鬉	zongBO
從	zongCM
蝬	zongCN
潀	zongEM
潈	zongEN
潨	zongEO
综	zongF
纵	zongFB
綜	zongFM
總	zongFN
縱	zongFO
緃	zongFP
総	zongFQ
緵	zongFR
緫	zongFS
縂	zongFT
縦	zongFU
繌	zongFV
鬷	zongGM
焧	zongHM
稯	zongHN
熧	zongHO
熜	zongHP
燪	zongHQ
棕	zongI
枞	zongIB
樅	zongIM
椶	zongIN
錝	zongJM
鍐	zongJN
鑁	zongJO
腙	zongL
朡	zongLM
粽	zongM
骔	zongMM
糉	zongMN
騌	zongMO
騣	zongMP
糭	zongMQ
碂	zongPM
磫	zongPN
猔	zongQM
猣	zongQN
昮	zongRM
嵏	zongSM
嵕	zongSN
嵸	zongSO
豵	zongSP
堫	zongTM
蓯	zongUM
葼	zongUN
蓗	zongUO
偬	zongV
傯	zongVM
倊	zongVN
倧	zongVO
总	zongX
惣	zongXM
惾	zongXN
愡	zongXO
翪	zongYM
鯮	zongYN
鯼	zongYO
踪	zongZ
蹤	zongZM
踨	zongZN
艐	zongZO
揍	zouA
掫	zouAM
搊	zouAN
齱	zouCM
齺	zouCN
奏	zouD
邹	zouF
陬	zouFB
鄹	zouFC
鄒	zouFM
郰	zouFN
緅	zouFO
楱	zouI
棸	zouIM
棷	zouIN
箃	zouKM
驺	zouM
騶	zouMM
黀	zouMN
媰	zouNM
菆	zouUM
蓙	zouUN
偢	zouVM
鲰	zouY
诹	zouYB
諏	zouYM
鯫	zouYN
鯐	zouYO
走	zouZ
赱	zouZM
攥	zuanA
揝	zuanAM
赚	zuanB
賺	zuanBM
劗	zuanDM
缵	zuanF
纘	zuanFM
繤	zuanFN
纉	zuanFO
欑	zuanIM
钻	zuanJ
鉆	zuanJM
鑚	zuanJN
鑽	zuanJO
纂	zuanK
篹	zuanKM
籫	zuanKN
躜	zuanZ
躦	zuanZM
组	zuF
阻	zuFB
族	zuFC
組	zuFM
綷	zuFN
靻	zuGM
租	zuH
稡	zuHM
厜	zuiCM
蟕	zuiCN
濢	zuiEM
絊	zuiFM
纗	zuiFN
稡	zuiHM
枠	zuiIM
栬	zuiIN
槜	zuiIO
樶	zuiIP
檇	zuiIQ
檌	zuiIR
欈	zuiIS
觜	zuiJ
鋷	zuiJM
錊	zuiJN
脧	zuiLM
朘	zuiLN
柤	zuIM
冣	zuiMM
睟	zuiMN
椊	zuIN
嫢	zuiNM
嘴	zuiO
咀	zuiOB
嗺	zuiOM
噿	zuiON
醉	zuiQ
酔	zuiQM
酨	zuiQN
酻	zuiQO
最	zuiR
晬	zuiRM
罪	zuiS
祽	zuiSM
嶊	zuiSN
嶉	zuiSO
嶵	zuiSP
蕞	zuiU
璻	zuiWM
辠	zuiXM
镞	zuJ
鏃	zuJM
鉐	zuJN
鉏	zuJO
鎺	zuJP
鎐	zuJQ
箤	zuKM
駔	zuMM
撙	zunA
拵	zunAM
捘	zunAN
尊	zunC
瀳	zunEM
罇	zunFM
繜	zunFN
樽	zunI
栫	zunIM
銌	zunJM
鐏	zunJN
袸	zunKM
鶎	zunNM
鷷	zunNN
噂	zunOM
嶟	zunSM
墫	zunTM
僔	zunVM
僎	zunVN
鳟	zunY
鱒	zunYM
譐	zunYN
遵	zunZ
跧	zunZM
踆	zunZN
撮	zuoA
捽	zuoAM
阼	zuoF
繓	zuoFM
左	zuoG
座	zuoGB
秨	zuoHM
稓	zuoHN
穝	zuoHO
柞	zuoI
柮	zuoIM
椊	zuoIN
鑿	zuoJM
鈼	zuoJN
凿	zuoK
笮	zuoKB
袏	zuoKM
筰	zuoKN
胙	zuoL
哫	zuOM
糳	zuoMM
唨	zuON
唑	zuoO
嘬	zuoOB
咗	zuoOM
唶	zuoON
酢	zuoQ
昨	zuoR
祚	zuoS
岝	zuoSM
岞	zuoSN
飵	zuoSO
坐	zuoT
苲	zuoUM
莋	zuoUN
葃	zuoUO
葄	zuoUP
蓙	zuoUQ
作	zuoV
做	zuoVB
佐	zuoVC
侳	zuoVM
琢	zuoW
怍	zuoX
諎	zuoYM
砠	zuPM
祖	zuS
卒	zuSB
卆	zuSM
崒	zuSN
崪	zuSO
菹	zuU
葅	zuUM
蒩	zuUN
俎	zuV
伜	zuVM
伹	zuVN
倅	zuVO
傶	zuVP
珇	zuWM
怚	zuXM
爼	zuXN
诅	zuY
詛	zuYM
謯	zuYN
足	zuZ
趲	zuZM
踤	zuZN
踿	zuZO
